都	a
不	b
是	c
到	d
么	e
地	f
上	g
有	h
小	i
出	j
以	k
人	l
那	m
了	n
就	o
这	p
我	q
要	r
大	s
他	t
的	u
中	v
在	w
和	x
文	y
发	z
考	aa
硕	ab
者	ac
摩	ad
教	ae
疆	af
与	ag
戎	ah
砂	ai
老	aj
弘	ak
戍	al
式	am
弪	an
礅	ao
魔	ap
成	aq
费	ar
张	as
礁	at
碰	au
或	av
碑	aw
砸	ax
碎	ay
碌	az
蚓	ba
而	bb
百	bc
蜻	bd
孕	be
周	bf
否	bg
蛟	bh
尕	bi
耐	bj
蚣	bk
内	bl
取	bm
刚	bn
及	bo
耻	bp
励	bq
见	br
同	bs
雁	bt
原	bu
职	bv
历	bw
面	bx
丹	by
骨	bz
时	ca
最	cb
易	cc
情	cd
性	ce
里	cf
量	cg
恢	ch
影	ci
懂	cj
怡	ck
怜	cl
怪	cm
忧	cn
惊	co
题	cp
明	cq
即	cr
愣	cs
昨	ct
果	cu
忡	cv
恻	cw
忽	cx
忙	cy
快	cz
衬	da
现	db
理	dc
慧	dd
看	de
至	df
补	dg
艘	dh
耗	di
丰	dj
瑞	dk
春	dl
初	dm
手	dn
玉	do
麦	dp
被	dq
帮	dr
玛	ds
玫	dt
琳	du
裾	dv
盘	dw
珂	dx
斑	dy
毛	dz
猪	ea
须	eb
狠	ec
生	ed
应	ee
庄	ef
店	eg
千	eh
孩	ei
度	ej
兴	ek
座	el
升	em
学	en
入	eo
序	ep
番	eq
底	er
翻	es
府	et
乎	eu
貌	ev
血	ew
自	ex
乱	ey
系	ez
城	fa
坏	fb
声	fc
款	fd
塘	fe
多	ff
外	fg
填	fh
未	fi
塔	fj
去	fk
夫	fl
坨	fm
于	fn
赤	fo
起	fp
均	fq
元	fr
垮	fs
堆	ft
平	fu
名	fv
馨	fw
志	fx
坟	fy
无	fz
语	ga
再	gb
更	gc
动	gd
话	ge
讲	gf
下	gg
计	gh
该	gi
列	gj
谋	gk
论	gl
开	gm
丈	gn
谈	go
正	gp
来	gq
殊	gr
天	gs
许	gt
说	gu
点	gv
设	gw
谢	gx
记	gy
互	gz
第	ha
南	hb
筷	hc
笔	hd
布	he
等	hf
乌	hg
献	hh
箫	hi
篮	hj
岛	hk
答	hl
友	hm
交	hn
灰	ho
篷	hp
郁	hq
简	hr
舅	hs
符	ht
策	hu
右	hv
笑	hw
算	hx
翅	hy
真	hz
寻	ia
尚	ib
温	ic
非	id
少	ie
法	if
污	ig
潮	ih
当	ii
油	ij
治	ik
刻	il
江	im
深	in
灵	io
涉	ip
洋	iq
洗	ir
尖	is
海	it
激	iu
群	iv
没	iw
河	ix
济	iy
汤	iz
藏	ja
英	jb
旧	jc
其	jd
师	je
艺	jf
葬	jg
若	jh
落	ji
莫	jj
期	jk
草	jl
紧	jm
蒙	jn
芳	jo
莲	jp
菊	jq
节	jr
疑	js
花	jt
蔽	ju
敬	jv
苏	jw
颖	jx
苦	jy
世	jz
饶	ka
视	kb
神	kc
祭	kd
馁	ke
社	kf
祯	kg
炭	kh
峭	ki
熊	kj
公	kk
谷	kl
分	km
带	kn
嵩	ko
峰	kp
能	kq
允	kr
参	ks
饭	kt
某	ku
台	kv
饥	kw
巍	kx
耀	ky
礼	kz
姥	la
奶	lb
她	lc
全	ld
好	le
转	lf
会	lg
较	lh
妇	li
个	lj
始	lk
从	ll
怒	lm
轻	ln
娘	lo
令	lp
软	lq
婚	lr
拿	ls
暂	lt
创	lu
如	lv
娇	lw
余	lx
姑	ly
今	lz
对	ma
家	mb
跟	mc
宝	md
字	me
完	mf
宣	mg
斗	mh
冰	mi
它	mj
共	mk
安	ml
实	mm
宜	mn
灾	mo
定	mp
次	mq
牢	mr
头	ms
准	mt
宋	mu
况	mv
功	mw
密	mx
割	my
决	mz
写	na
振	nb
提	nc
承	nd
农	ne
将	nf
打	ng
技	nh
把	ni
北	nj
县	nk
热	nl
按	nm
挥	nn
护	no
挺	np
换	nq
报	nr
摆	ns
收	nt
杀	nu
据	nv
投	nw
拒	nx
挤	ny
接	nz
烧	oa
高	ob
良	oc
炜	od
州	oe
灶	of
灯	og
鸭	oh
京	oi
霸	oj
煤	ok
熟	ol
露	om
义	on
炉	oo
雾	op
炮	oq
酷	or
雷	os
放	ot
霞	ou
房	ov
为	ow
烟	ox
配	oy
永	oz
过	pa
还	pb
退	pc
违	pd
追	pe
进	pf
处	pg
歧	ph
建	pi
此	pj
逡	pk
连	pl
冬	pm
步	pn
遍	po
通	pp
肯	pq
造	pr
达	ps
近	pt
道	pu
各	pv
务	pw
透	px
迹	py
予	pz
肘	qa
危	qb
胆	qc
精	qd
胜	qe
脚	qf
印	qg
胶	qh
争	qi
用	qj
勾	qk
数	ql
留	qm
粗	qn
久	qo
腿	qp
朋	qq
服	qr
类	qs
腹	qt
善	qu
然	qv
负	qw
着	qx
脑	qy
断	qz
衙	ra
闻	rb
很	rc
际	rd
制	re
行	rf
卫	rg
德	rh
律	ri
特	rj
微	rk
除	rl
院	rm
风	rn
防	ro
随	rp
阴	rq
先	rr
隔	rs
附	rt
闲	ru
问	rv
虎	rw
阿	rx
往	ry
气	rz
夺	sa
骤	sb
重	sc
奈	sd
帘	se
黑	sf
尝	sg
置	sh
事	si
融	sj
骏	sk
容	sl
空	sm
爽	sn
太	so
略	sp
胃	sq
窖	sr
骑	ss
窄	st
夹	su
常	sv
男	sw
思	sx
驻	sy
累	sz
代	ta
仍	tb
但	tc
段	td
任	te
怎	tf
信	tg
什	th
伊	ti
化	tj
似	tk
集	tl
兵	tm
优	tn
停	to
健	tp
你	tq
们	tr
后	ts
作	tt
所	tu
保	tv
侧	tw
何	tx
做	ty
位	tz
村	ua
极	ub
查	uc
曾	ud
首	ue
美	uf
本	ug
半	uh
档	ui
模	uj
松	uk
检	ul
并	um
攀	un
术	uo
格	up
前	uq
株	ur
关	us
整	ut
林	uu
总	uv
机	uw
想	ux
柱	uy
已	uz
号	va
虽	vb
喝	vc
屋	vd
响	ve
呀	vf
层	vg
叶	vh
吧	vi
尼	vj
只	vk
哈	vl
展	vm
叫	vn
尽	vo
足	vp
吹	vq
兄	vr
吗	vs
吃	vt
品	vu
呢	vv
别	vw
呵	vx
居	vy
局	vz
赌	wa
赈	wb
鲁	wc
瘢	wd
存	we
痣	wf
病	wg
瘦	wh
疤	wi
则	wj
办	wk
痊	wl
瘫	wm
疗	wn
凡	wo
痛	wp
鲜	wq
乔	wr
账	ws
疾	wt
朵	wu
加	wv
婴	ww
稣	wx
瘁	wy
赔	wz
射	xa
秀	xb
香	xc
国	xd
必	xe
园	xf
团	xg
睨	xh
稍	xi
利	xj
私	xk
委	xl
科	xm
区	xn
秋	xo
图	xp
称	xq
匹	xr
因	xs
医	xt
困	xu
回	xv
秃	xw
哥	xx
固	xy
鼎	xz
铐	ya
钢	yb
银	yc
铸	yd
市	ye
主	yf
钱	yg
镇	yh
销	yi
钊	yj
育	yk
铃	yl
错	ym
离	yn
变	yo
键	yp
望	yq
克	yr
亩	ys
改	yt
旁	yu
钟	yv
亢	yw
忌	yx
翠	yy
顿	yz
绕	za
敢	zb
意	zc
绩	zd
产	ze
结	zf
线	zg
续	zh
剥	zi
缆	zj
端	zk
给	zl
红	zm
经	zn
幻	zo
终	zp
约	zq
纸	zr
司	zs
维	zt
亲	zu
部	zv
缨	zw
练	zx
纯	zy
书	zz
磊	aaag
考	aab
碱	aaes
硗	aagr
砩	aarf
磨	aas
弭	abb
弼	abca
碉	abfv
砺	abgq
碘	abmk
弋	abn
砚	abra
硐	absg
硕	abws
者	acg
碍	acga
砷	acjf
煮	acoy
碣	acqz
都	acrf
翥	acyy
弛	acz
摩	adnl
碛	adws
弧	adx
碡	adzs
麾	adzx
矿	aed
戚	aegi
威	aegl
孝	aegn
蹙	aegp
麽	aeko
砭	aeps
咸	aesg
感	aesx
戊	aet
教	aetn
臧	aezj
矸	aff
硅	affg
磔	affu
疆	afgg
砝	afks
磕	afkw
砑	afnd
矽	afs
砰	afud
贰	afwy
砖	afzo
硬	agcn
与	agg
研	agmf
硎	agmj
欤	agql
尧	agrb
翘	agry
礓	agsg
石	agt
砧	agvg
鸢	ahg
磙	ahkb
戎	aht
靡	aids
砂	aied
硝	aiqg
磲	aixu
泵	aiy
老	ajb
耆	ajcg
耋	ajdf
耄	ajdz
划	ajf
礴	ajia
砒	ajja
礤	ajkd
础	ajkf
砌	ajmd
礞	ajnb
砹	ajns
引	ajv
硭	ajyz
碟	ajzu
甙	akg
碳	akho
碜	akse
磴	aksu
弘	akx
砗	alf
硷	alge
砼	almg
戍	aly
弱	amam
碗	amfu
式	amg
碹	amgg
戒	amh
砣	amja
磺	amjk
磉	ammu
碇	amps
弪	anmb
礅	aoen
麻	aon
碥	aovw
魔	apo
硌	apvg
鬻	aqaj
粥	aqaz
成	aqb
硪	aqd
磷	aqfj
弥	aqix
砍	aqls
磋	aqmg
破	aqms
糜	aqo
硼	aqqg
确	aqqj
盛	aqwg
硒	arg
弗	armn
砜	arns
砥	aros
艴	arqi
费	arwp
码	asg
硖	asug
张	asx
砟	atfg
戌	atg
碓	atlg
礁	atlo
戈	atn
砾	ats
斫	attf
五	aty
碴	aucg
弹	auch
碰	aumg
磁	auzo
强	avbx
吾	avg
或	avgg
惑	avgx
碾	avmb
犟	avrj
矶	awa
碑	awhf
硇	awns
矾	awos
砸	axef
忒	axy
硫	ayke
碎	aylh
寸	ayn
碲	ayue
磅	ayuo
砘	ayza
弦	ayzo
碌	azfi
砬	azg
弓	azn
縻	azoi
砀	azrd
碚	azvg
蛲	bagr
蚓	bajj
蜮	bavg
聃	bbfg
蚺	bbfh
蜩	bbfv
册	bbgd
蛎	bbgq
而	bbjh
耍	bbjl
恧	bbjx
蚋	bbll
蛐	bbmh
燹	bboy
蚬	bbrm
螈	bbui
聩	bbws
厦	bbxp
蜴	bcck
厚	bceg
厘	bcfg
厩	bcfr
百	bcg
乃	bcn
蝎	bcqz
蜾	bcul
蛭	bdfh
蚌	bdjj
蝽	bdlc
螓	bdlx
蜻	bdqh
蚝	bdzm
孕	bed
蜉	beeh
螗	beiv
蟠	beqs
蟋	beqx
蠊	beuo
蜢	bewh
螅	bexx
聒	beyg
蛞	beyh
辱	bfba
蜃	bfbb
唇	bfbv
辰	bfby
蛙	bffh
冉	bffn
蚨	bfll
蚜	bfnk
压	bfoy
冕	bfqr
蟛	bfue
周	bfvd
冒	bfxf
螬	bgbc
蟪	bgcx
丕	bggg
虾	bggl
歪	bggp
删	bgjr
孬	bgle
耵	bgnf
厅	bgnh
厉	bgqb
甭	bgqj
邳	bgrf
耳	bgt
否	bgvg
不	bgy
蝻	bhbh
螋	bhjm
蛟	bhnl
尕	bii
蛸	biqh
聘	bjaa
耐	bjas
蜞	bjdk
厮	bjdt
蛳	bjee
螨	bjgl
蚰	bjh
鸸	bjhg
蟆	bjjl
蚍	bjjm
蠓	bjnb
蝾	bjnu
蠛	bjsl
蠖	bjtm
蟒	bjvm
蝶	bjzu
蚶	bkh
蚣	bkkl
蛑	bkrj
蝓	blgj
厍	blh
劂	bljf
肉	bllu
蛉	blpl
聆	blps
蚧	blrj
蛤	blsh
内	blun
蜍	blxl
仄	bly
厝	bmcg
蜡	bmch
蛏	bmfh
曲	bmfn
蜿	bmfu
聍	bmgn
虹	bmh
蚪	bmhj
蟥	bmjk
蛇	bmjm
典	bmku
娶	bmlg
颞	bmmw
聂	bmmy
取	bms
鄹	bmtr
聚	bmty
盈	bmwd
螟	bnch
蛆	bnh
刚	bnjj
网	bnnu
耽	bnra
冈	bnu
蠕	bobj
螂	bocr
及	boin
蚁	bonl
耿	bos
蝣	bote
蝙	bovw
蜂	bpdj
蜓	bpef
蜒	bpep
耻	bpg
蛹	bpqj
蟾	bqbg
髁	bqcu
聊	bqer
鹘	bqhh
骸	bqil
蛘	bqj
蛾	bqk
蝼	bqlh
骱	bqlr
髌	bqmk
髋	bqmr
髂	bqmv
髓	bqpq
骼	bqpv
髅	bqql
骶	bqro
髑	bqsb
骺	bqts
蟮	bquv
蟓	bqvb
励	bqwd
髀	bqwh
骰	bqwm
骷	bqyh
蜣	bqzm
螵	brdl
耶	brf
蛛	bril
见	brv
同	bsf
蝰	bsff
蚂	bsh
鸯	bshf
蝠	bssh
厨	bsua
蛱	bsuh
央	bsun
螳	bsvf
盎	bswf
螺	bszi
蝮	btcp
蚱	btfh
虼	btfm
蚯	btmh
厂	btn
蜘	btsv
雁	bttl
赝	bttw
厄	bub
顾	bubw
蝉	buch
蝗	budh
愿	buix
原	buiy
厥	bujl
虫	bun
蝤	buoh
联	buss
蜷	busu
蜥	butt
蜕	buvr
聪	buvx
厢	buxg
罔	buyz
靥	bvbf
豳	bvbk
蜗	bvbl
豕	bvby
蝇	bvcz
蜈	bvgs
职	bvks
餍	bvlc
冂	bvnp
厣	bvoh
魇	bvpy
雕	bvtl
厌	bvy
戤	bwae
蛊	bwf
蜱	bwhj
厕	bwjh
虮	bwm
历	bwt
贵	bwu
页	bwy
戛	bxat
蝈	bxdo
蚵	bxj
面	bxjf
蜊	bxjj
蝌	bxmh
夏	bxpy
蛔	bxvh
勖	bxwk
蠼	bxxm
鼐	bxzz
丹	bydn
彤	byee
蛀	byfh
蛄	byh
蟀	byih
螭	bynk
蚊	bynl
蛴	bynr
蝴	byqh
螃	byuo
虻	byzm
蟑	bzlj
虬	bzm
骨	bznq
蚴	bzow
暑	cacf
憾	caex
晓	cagr
时	cal
忖	cao
晟	caqv
怫	caru
晤	cavh
悟	cavy
晨	cbfb
惆	cbfv
怀	cbgo
禺	cbku
愚	cbkx
昃	cblu
慑	cbmm
最	cbmu
映	cbsl
怏	cbso
恫	cbsy
惘	cbuz
恹	cbvo
愦	cbwo
晶	cccf
惕	ccci
惺	cced
昌	ccf
慨	ccfr
悍	ccfu
悝	ccfy
怛	ccgy
剔	ccjj
曝	ccmi
恨	cco
憬	ccoi
易	ccr
慢	ccsm
巢	ccup
愠	ccwy
惚	ccxo
戥	cdak
旺	cdh
晴	cdqh
情	cdqy
愫	cdzi
懊	cebs
晌	cebv
星	cedf
性	cedy
暖	cefm
惦	cegv
忏	cehu
慷	ceii
慵	ceij
旷	cek
勿	cen
暧	cenm
恤	cewy
恬	ceyy
垦	cfa
恃	cfao
暨	cfcg
里	cffn
昧	cfil
旱	cfj
旰	cfjn
怯	cfko
曰	cfn
忆	cfp
野	cfpn
既	cfrz
日	cft
悻	cfuh
怦	cfui
怃	cfzp
量	cgcf
恒	cgcg
昙	cgdu
恸	cgdw
旦	cgf
悼	cglu
怔	cgpy
昊	cgsu
怖	cheu
愤	chjw
惰	chmq
悖	chne
忮	cho
恢	choo
慎	chzk
惝	cibv
颢	cibw
悱	cidy
影	ciek
悄	ciqy
晁	cirv
申	cjjn
昆	cjjv
悭	cjmf
刎	cjr
曳	cjrn
懂	cjsc
懵	cjsx
慌	cjye
畅	cjzr
惴	ckbj
暌	ckgs
忪	ckko
悛	ckkp
恍	ckp
惨	ckse
晃	ckv
怡	ckvy
恺	ckyp
愉	clgj
忄	clnp
怜	clpo
恰	clsy
惭	cltt
怆	clup
旯	clv
晗	clzv
惜	cmcy
显	cmf
怿	cmfj
惋	cmfu
怪	cmfy
暄	cmgg
忉	cmi
暴	cmki
晏	cmlf
照	cmou
昭	cmvh
怊	cmvy
暝	cnch
晕	cnl
晖	cnlj
恽	cnlu
晡	cnqh
忱	cnrp
忧	cnzp
懦	cobj
暾	coen
晾	coil
匆	coin
惊	coio
景	coiu
炅	cou
题	cpbw
韪	cpdj
墅	cpff
晷	cpgv
匙	cpjm
艮	cpn
愧	cpo
是	cpu
恪	cpvy
恂	cqcy
昴	cqer
明	cqh
懈	cqjj
曷	cqlz
昀	cqmh
煦	cqou
昂	cqrj
晚	cqvr
盟	cqwf
晒	crh
即	crv
悯	cryn
忾	crzp
甾	csa
曙	csac
曼	csmu
怅	cso
愣	csop
曛	csso
愎	ctcp
昨	ctfh
怍	ctfy
忤	cthu
晔	ctjh
憔	ctlo
惟	ctly
昕	cttj
忻	cttu
晦	ctzl
悔	ctzo
悌	cuan
颗	cubw
惮	cuch
憎	cudc
惶	cudy
曦	cufa
夥	cuff
暇	cufm
愕	cuga
慊	cuio
剿	cujv
怵	cuoo
晰	cutt
杲	cuu
果	cuun
憷	cuup
悦	cuvr
懒	cuvw
悚	cuvy
怕	cuy
悒	cvip
邕	cviz
昵	cvjm
怩	cvjp
忡	cvju
恻	cwju
眉	cxa
悸	cxey
鹛	cxhb
忽	cxi
怄	cxno
愀	cxoo
恳	cxp
惬	cxsu
悃	cxuo
忭	cygo
悴	cylh
恼	cynj
曩	cyub
懔	cyxd
怙	cyy
曜	cyyl
忙	cyzp
憧	czcf
暗	czch
昱	czf
忸	czfy
惯	czhw
惧	czko
也	czn
巛	cznp
歇	czql
快	czso
电	czvn
褚	dacy
衬	dao
襁	davb
珊	dbbg
褥	dbfa
瑁	dbfx
珥	dbg
环	dbgs
衲	dblo
现	dbra
舰	dbrq
琢	dbvb
顼	dbws
裼	dcci
理	dcfg
袒	dcgy
琨	dcjj
裉	dco
褐	dcqz
裸	dcuo
韫	dcwg
瑙	dcwn
裱	ddeb
玮	ddf
琶	ddib
彗	ddig
慧	ddix
琵	ddjj
琴	ddlz
珏	ddos
瑟	ddxe
焘	deao
寿	deay
表	deby
拜	dedh
瑗	defm
衽	defy
韬	dehg
衫	dei
瑭	deiv
掰	dekn
搿	deln
裤	delu
瑷	denm
邦	derf
瑶	derk
艋	dewt
看	dexd
臻	dfdx
褂	dffg
至	dfg
到	dfjf
珐	dfks
琊	dfnr
玩	dfra
郅	dfrf
致	dftn
艚	dgbc
璨	dgfq
王	dgn
玎	dgnf
补	dgo
袜	dguo
舻	dgve
玷	dgvg
艘	dhjm
韦	dhn
耱	diaa
耨	diba
耦	dick
耗	didz
耔	dieg
裙	diev
耕	difr
耘	digd
耩	digf
耙	diia
耖	diie
耥	diiv
裆	diiy
耢	dijw
耠	dils
瓜	din
耧	diql
艄	diqt
珧	dira
舟	dit
琐	diws
耜	dixg
耒	diyn
耪	diyo
砉	djag
瑛	djbs
琪	djdk
丰	djhn
舭	djjq
褡	djls
艨	djnb
艳	djqi
舳	djt
褴	djtw
瑾	djvd
袖	djy
瑞	dkbj
裕	dklv
玢	dkmd
舢	dkr
璀	dktl
蠢	dlbb
春	dlcg
珍	dled
奉	dlfj
裣	dlge
瑜	dlgj
奏	dlgs
舂	dlhg
泰	dliy
玲	dlps
袷	dlsy
舱	dluq
秦	dlxy
衿	dlzp
挈	dmdn
琮	dmds
琬	dmfu
弄	dmh
初	dmi
璜	dmjk
舵	dmjq
珙	dmks
裰	dmmm
韧	dmos
璐	dmpv
璞	dmqo
契	dmsy
舡	dmt
恝	dmxy
球	dnis
珑	dnjd
褙	dnjq
手	dnkn
琛	dnku
珲	dnlf
衩	dno
襦	dobj
琅	docs
班	doed
琼	dois
衤	donp
舣	donw
琰	doos
舫	doq
璇	dotp
褊	dovw
玉	doy
珉	dpa
褪	dpco
艇	dpef
麸	dpfl
琏	dplf
裢	dplu
麴	dpqq
瑰	dps
珞	dpvg
袼	dpvy
麦	dpy
靓	dqbr
青	dqg
褛	dqly
被	dqmo
靛	dqmp
玻	dqms
玖	dqos
静	dqqn
敖	dqtn
袍	dqup
璩	drbb
裥	drcy
帮	dreh
珩	drfn
珠	dris
瓞	drlw
瓒	drrw
舾	drt
琥	drwa
玛	dsg
琦	dsxf
玳	dtaa
聱	dtbg
螯	dtby
舴	dtft
鏊	dtlu
舨	dtmw
玫	dtns
熬	dtoy
褫	dtrw
骜	dtsg
袱	dtvo
褓	dtvu
獒	dtvy
鳌	dtwg
赘	dtwy
三	dty
碧	duag
艏	duex
瑕	dufm
珀	dug
袢	duhu
襻	dunn
酆	durf
舶	dut
襟	duud
噩	duug
琳	duus
裎	dvdy
艉	dvdz
舯	dvjr
琚	dvyg
裾	dvyy
玑	dwa
磐	dwad
盘	dwd
裨	dwhu
般	dwmw
袄	dwo
璁	dwpx
珈	dwvg
船	dwvt
璎	dwwl
责	dwy
珂	dxf
舸	dxr
琉	dyke
示	dyn
斑	dynd
璃	dynk
玟	dyns
瑚	dyqg
航	dywq
褶	dyyu
舷	dyzo
艟	dzcf
毛	dzcn
毳	dzdz
毡	dzgv
毪	dzkj
璋	dzlf
素	dzoi
毯	dzoo
毽	dzpj
袂	dzso
氆	dzuc
氇	dzwc
毒	dzy
纛	dzzi
猪	eact
狨	eahe
猕	eaqi
狒	earr
虢	earw
子	eat
橥	eaui
帽	ebfx
奥	ebqs
觅	ebrc
獗	ebul
向	ebvd
独	ebw
须	ebww
猾	ebzq
猖	ecct
猩	eced
廛	ecff
狸	ecft
幌	eckm
幔	ecsm
猓	ecuw
狠	ecw
猸	ecxt
生	edd
帱	edea
帏	edj
廒	edqn
猜	edqt
甥	edsw
狂	edt
狐	edw
帻	edwl
孤	edx
眚	edxd
孚	eed
犷	eee
狲	eeiw
币	eek
犭	een
彡	eenp
幡	eeqs
郛	eerr
应	ees
猛	eewt
憩	eexi
乳	eezq
壬	efd
丢	efki
爰	efmi
犴	efr
庄	efs
猿	efvb
庑	efzx
狺	egt
帖	egvh
店	egvs
狱	egvw
帧	egwl
舀	ehd
千	ehk
庾	ehlo
乖	ehnj
狡	ehnw
庋	eho
歃	ehql
猊	ehrq
片	ehzc
康	eiio
唐	eijv
庚	eilo
赓	eilw
孩	eilx
爪	ein
爬	eiq
庸	eiqj
孙	eix
乇	ejc
狮	ejee
席	ejel
狴	ejjf
庇	ejjx
度	ejmo
巾	ejn
庶	ejoo
庙	ejs
猫	ejst
獾	ejul
廑	ejvd
庹	ejvo
庀	ejx
繇	ekei
举	ekfj
誉	ekgs
鹞	ekht
么	eki
狻	ekkp
年	ekn
兴	eko
狁	ekrq
妥	eld
猞	elfv
狯	elgd
猃	elge
库	ell
座	ellf
犰	elq
狳	elxw
狩	emaw
猎	emct
狞	emgn
升	emk
幞	emqo
觉	enbr
璺	endo
学	enes
舜	enfj
爱	enhm
泶	enio
庞	enjw
受	enmi
黉	enmk
丿	ennp
喾	enrv
狙	ent
爨	enuo
鲎	enws
犹	enzq
孺	eobj
廊	eocr
狼	eocw
廓	eoer
鹧	eohy
入	eoi
汆	eoii
籴	eoqi
狎	eor
庐	eovw
狄	eow
庭	epef
乏	epi
序	epzn
猱	epzu
狰	eqin
獬	eqjj
釉	eqjt
庠	eql
释	eqmj
帔	eqml
廨	eqqj
番	eqsd
狍	equq
庖	equx
孢	equz
狗	eqvt
悉	eqxi
鼾	erfr
劓	erjr
帙	erll
鼽	erlq
底	eroo
邝	eru
齄	erug
爵	esca
庵	escz
睾	esfh
猡	esfw
猥	esgb
帐	esl
庆	eso
猬	esqt
鄱	esrr
幅	essh
獯	esso
犸	est
獠	esui
狭	esut
猗	esxr
翻	esyy
腐	etal
府	etao
帷	etlh
孜	etnx
鹰	etth
膺	ettq
庥	etuo
猴	etzs
猹	eucg
彩	euee
帕	euh
采	eui
廉	euio
乎	eunk
床	euo
犯	euq
獭	euvw
貊	evbc
禹	evbk
幄	evdf
豸	eve
豺	evgn
貘	evjj
帜	evkl
貂	evmv
貉	evpv
狷	evqt
豹	evqw
貅	evtu
貌	evur
貔	evwj
孟	ewa
血	ewd
庳	ewhl
广	ewn
帆	ewol
衅	ewuh
狈	eww
勐	ewwc
衄	ewzf
自	exd
帼	exdo
阜	exhk
猁	exjr
鼻	exsr
臬	exui
臭	exvi
息	exxi
舌	eyd
舔	eygx
鸹	eyht
刮	eyjr
甜	eykt
猝	eylh
猢	eyqt
舐	eyrq
敌	eytn
廪	eyxd
廖	eyye
辞	eyzh
乱	eyzq
幢	ezcf
獍	ezcr
狃	ezft
牍	ezhs
牒	ezju
幛	ezlj
獐	ezlr
系	ezoi
牖	ezoq
奚	ezos
废	ezpo
胤	ezqz
版	eztm
牌	ezwh
孔	ezz
堵	facg
城	faqa
域	favg
彀	fawm
寺	fay
坯	fbgg
坏	fbgs
圾	fbos
垌	fbsg
塬	fbui
坜	fbwd
顸	fbws
坍	fbyg
地	fca
埘	fcas
埸	fccd
埋	fcfg
坦	fcgg
坤	fcjf
堤	fcps
垠	fcs
墁	fcsm
声	fct
塌	fcyy
垤	fdfg
款	fdql
埒	feas
垧	febv
圹	fed
甏	fego
墉	feij
塘	feiv
埠	fexh
封	ffas
替	ffcg
圭	ffg
卦	ffgs
多	ffi
舛	ffjr
辇	fflh
圩	ffnf
坪	ffud
桀	ffui
墙	ffuv
恚	ffxy
圬	fgaa
垣	fgcg
埂	fgcn
坛	fgds
垭	fgmg
土	fgn
士	fgt
垆	fgvd
坫	fgvg
外	fgw
盐	fgwg
坞	fhgg
干	fhn
鼙	fhwh
瞽	fhxg
埴	fhzg
填	fhzk
埭	fiis
垓	fils
墚	fimu
夕	fin
埽	fine
未	fiyn
堪	fjdz
刊	fjf
塔	fjls
觳	fjwm
堞	fjzu
坩	fkg
击	fkhn
却	fkrf
埃	fkts
劫	fkwd
盍	fkwg
去	fky
垲	fkya
规	flbr
飧	flcw
毂	flwm
夫	flyn
埝	flzx
垸	fmfr
夤	fmgk
坨	fmja
亍	fnh
鸦	fnhg
于	fnhn
垅	fnjd
壶	fnmg
乙	fnn
埔	fnqg
邪	fnrf
壹	fnsu
雅	fntl
牙	fntn
壳	fnwb
盂	fnwg
悫	fnwx
坊	foa
赭	foac
墩	foen
赫	fofo
壕	fonb
郝	forf
赧	form
赦	fotn
赤	foy
越	fpaz
趣	fpbm
埏	fpep
赶	fpff
址	fpg
趔	fpgj
赴	fpgs
趟	fpiv
趁	fple
趑	fpml
超	fpmv
赳	fpnf
趄	fpng
赵	fpns
趋	fpqi
趱	fprw
走	fpy
起	fpya
坎	fqls
均	fqmg
坡	fqms
堋	fqqg
堍	fqvo
元	frb
顽	frbw
邗	frf
堙	frfg
亓	frh
井	frhn
圳	frjf
墟	frmg
坻	fros
鼋	frvz
塥	fsbj
埯	fscz
垮	fsga
塄	fsoa
嫠	ftbl
螫	ftby
圪	ftfa
堆	ftlg
坂	ftms
垢	ftsg
圻	fttf
坼	ftto
二	fty
堠	ftzs
圯	fua
丧	fuby
增	fudc
彭	fued
鸳	fuhd
幸	fuhh
鼓	fuhs
懿	fumx
平	fut
眢	fuxd
怨	fuxi
啬	fuxv
埚	fvbl
颉	fvbw
名	fvd
埕	fvdg
袁	fveb
吉	fvg
墀	fvij
坭	fvja
堀	fvjk
熹	fvuo
喜	fvuv
埙	fvws
嘉	fvwv
磬	fwag
謦	fwgg
埤	fwhf
罄	fwrk
坝	fws
垛	fwus
馨	fwxc
堰	fxcl
坷	fxf
志	fxy
圮	fya
垴	fynj
坟	fyns
壤	fyub
墒	fyuv
坑	fywa
无	fzb
境	fzcr
垃	fzg
坳	fzow
专	fzoy
场	fzrd
坶	fzs
块	fzss
培	fzvg
亏	gab
诸	gacy
诫	gamu
试	gamy
讨	gao
武	gapg
诚	gaqp
戋	gatn
语	gavy
盏	gawg
再	gbfg
调	gbfv
两	gbll
讷	gblo
丙	gbly
曹	gbmc
诹	gbmo
鹂	gboh
丽	gboo
郦	gbor
殃	gbss
诼	gbvb
戬	gcad
亘	gcgg
惠	gckx
更	gcny
谒	gcqz
谩	gcsm
课	gcuo
桌	gcuu
诔	gdio
魂	gdps
请	gdqy
讳	gdu
动	gdwd
云	gdy
诳	gedy
殍	geeg
谖	gefm
歼	gehf
谣	gerk
话	geyy
诗	gfao
觏	gfbr
诖	gffy
讶	gfni
殪	gfnu
谮	gfrc
讲	gfru
讦	gfu
评	gfui
诘	gfvy
残	ggad
上	ggf
卡	gggu
让	gggy
订	ggnu
讣	ggo
证	ggpy
忐	ggxu
忑	ggxy
下	ggy
丐	ggzb
谳	ghhv
谀	ghlo
诙	ghoo
计	ghu
殖	ghzg
读	ghzs
诽	gidy
妻	gijl
该	gilo
叔	giml
诮	giqy
死	gjb
诣	gjcy
谌	gjdz
列	gjf
型	gjfg
诺	gjhv
谟	gjjo
谐	gjju
诎	gjku
烈	gjoy
谨	gjvd
裂	gjyb
谎	gjye
谍	gjzu
讼	gkko
诶	gkts
讪	gku
谋	gkuo
殆	gkvg
诒	gkvy
诠	gldy
殄	gled
诊	glei
殓	glge
谕	glgj
卓	glj
论	gljp
餮	gllc
谶	gllg
认	glo
邴	glrf
谂	glzx
晋	gmcg
形	gmed
诧	gmej
严	gmet
壑	gmff
垩	gmfg
译	gmfj
亚	gmg
开	gmh
刑	gmjf
餐	gmlc
诬	gmll
谊	gmny
粲	gmqu
谘	gmqv
邢	gmrf
殡	gmtk
攴	gmu
诏	gmvy
督	gmxf
恶	gmxy
讧	gmy
顶	gnbw
殂	gng
睿	gngx
丁	gnh
诨	gnlu
鹾	gnqm
才	gntn
殛	gnvg
诅	gny
丈	gnyn
谆	goey
谅	goio
议	gono
谈	gooo
访	gop
鄢	gorf
谝	govw
灭	goy
焉	gpao
谴	gpbx
诞	gpep
正	gpg
鹉	gphg
诵	gpqj
谜	gpqo
政	gptn
谲	gpzv
万	gqb
谵	gqbg
诡	gqbu
虿	gqby
殉	gqcg
询	gqcy
谄	gqhy
诤	gqin
诌	gqiy
详	gqu
谗	gqvm
趸	gqvp
劢	gqwd
赉	gqwy
来	gqyn
兀	grb
虺	grbs
丌	grh
诛	grio
殊	gris
训	grju
谭	grlu
讽	grno
诋	groo
诜	grrp
谰	grus
诰	grvy
谑	grxg
蚕	gsby
画	gsjh
谡	gskp
谓	gsqy
言	gst
吞	gsvg
谠	gsvr
忝	gsxy
天	gsy
讫	gtfp
诈	gtfy
许	gthu
讹	gtjp
谯	gtlo
谁	gtly
诟	gtsy
诉	gtto
一	gty
诲	gtzo
殇	gtzr
殚	guch
谔	guga
谦	guio
谥	gukw
谱	gumc
卜	gun
谫	guqm
谏	gusy
说	guvr
末	guyn
战	gvak
觇	gvbr
颅	gvbw
占	gvf
误	gvgs
鸬	gvhh
识	gvko
点	gvou
卢	gvr
殒	gvws
乩	gvzm
设	gwmo
殁	gwms
讥	gwp
贞	gwu
谢	gxao
诱	gxbp
诓	gxdy
谧	gxew
诿	gxly
讴	gxno
讠	gxnp
卤	gxnu
诃	gxu
卣	gxuf
讵	gxuy
谇	gylh
歹	gyn
记	gyp
谛	gyue
谤	gyuo
谪	gyuy
诂	gyy
谬	gyye
诩	gyyy
谙	gzcy
谚	gzee
互	gzg
讯	gzhu
诀	gzso
词	gzsy
瓦	gzzo
箸	hacd
箴	haes
载	halh
第	hane
戴	hask
截	hatl
栽	hauy
哉	havg
裁	hayb
笈	hboi
笕	hbrc
筒	hbsd
南	hbuh
篑	hbwi
笏	hce
笪	hcgd
簋	hcwd
筷	hczs
筹	hdea
籍	hdic
臼	hdn
箐	hdqd
鸟	hdt
箦	hdwi
笔	hdzc
笙	hedd
布	heh
鹁	hehg
笊	hei
勃	hewd
笫	hezn
等	hfai
竺	hfd
簪	hffc
竿	hfk
竽	hfnk
筠	hfqm
笺	hgae
筻	hgcn
乌	hgd
篝	hgmf
笄	hgmk
邬	hgrr
十	hhn
献	hhvs
笆	hic
笋	hiee
箫	hiir
簿	hina
筲	hiqd
箔	hiud
盥	hiwd
笛	hjd
箕	hjdk
簸	hjdm
筛	hjee
箬	hjhv
筚	hjjh
叟	hjmi
鹱	hjtm
篮	hjtw
贲	hjwy
颠	hkbw
衮	hkeb
岛	hkk
兖	hkrx
簦	hksu
雄	hktl
笞	hkvd
戟	hlad
筌	hldd
韩	hldf
签	hlge
舆	hlgk
臾	hlin
斡	hllh
赍	hllw
翰	hlly
朝	hlqg
答	hlsd
乾	hltf
箢	hmfu
左	hmg
卉	hmh
簧	hmjk
鸵	hmjq
舁	hmk
筮	hmll
筇	hmrk
笤	hmvd
毁	hmwm
筑	hmwo
管	hmxd
友	hmy
孛	hneg
筢	hnic
笼	hnje
箝	hnkd
箨	hnmj
交	hno
博	hnqa
籀	hnqs
郊	hnru
效	hntn
筘	hnvd
箍	hnxe
索	hnzi
鼯	hoav
篙	hobv
鼠	hoc
鼹	hocl
鼷	hoes
鼬	hojt
鼢	hokm
簇	hots
篇	hovw
盔	howg
灰	hoy
筵	hpep
篷	hppj
笾	hpwe
有	hqg
筝	hqin
篓	hqld
舄	hqoi
郁	hqrf
篼	hqur
笱	hqvd
筋	hqwe
簖	hqzt
简	hrcd
簟	hrlk
竹	hrn
筅	hrrc
篥	hrui
篾	hsal
觌	hsbr
笃	hsd
箩	hsfi
箅	hsgr
箜	hsmd
舅	hswe
筏	htae
符	htai
簏	htc
笮	htfd
筱	htjn
篪	htrw
六	hty
篌	htzs
策	hubc
箪	huch
篁	hudd
笨	hugd
枭	hui
箭	huqj
簌	huvl
籁	huvw
箱	huxd
右	hvg
凫	hwc
笑	hwi
篦	hwjj
协	hwks
笳	hwvd
筐	hxdd
篚	hxid
算	hxmk
纂	hxsi
篡	hxsk
箧	hxsu
笸	hxvd
袅	hyeb
支	hyn
篱	hynk
翅	hyyg
尢	hzb
笠	hzd
篆	hzeb
直	hzg
矗	hzhz
尴	hzjw
真	hzky
尬	hzlr
卖	hzms
尥	hzqs
笥	hzsd
渚	iacy
浇	iagr
泓	iako
溺	iamm
彐	ianp
寻	iap
沸	iaru
涨	iaso
浯	iavy
溽	ibfa
涯	ibff
滠	ibmm
澧	ibmu
浊	ibo
汲	iboo
泱	ibso
洞	ibsy
源	ibui
涿	ibvb
尚	ibvf
沥	ibwi
溃	ibwo
湎	ibxf
洱	iby
滑	ibzq
沓	icf
溉	icfr
涅	icfy
灏	iciw
混	icjj
瀑	icmi
湿	icmy
池	icp
渴	icqz
漫	icsm
淄	icsy
温	icwy
湄	icxy
汩	icy
汨	icyn
溻	icyy
蜚	idbu
涛	idea
湃	ideh
韭	idgf
非	idh
滟	idji
沣	idju
辈	idlj
溱	idlx
清	idqy
渍	idwo
悲	idxu
汪	idy
裴	idyb
斐	idyn
翡	idyy
潴	ieac
澳	iebs
淫	ieef
浮	ieey
滔	iehy
溏	ieiv
渡	iejm
泛	iepo
渊	ieqj
尹	ieqn
潘	ieqs
少	ier
漪	iesx
濂	ieuo
君	ieva
劣	iewr
洫	iewy
省	iexf
濞	iexr
溴	iexv
洎	iexy
活	ieyy
溪	iezs
尘	iff
洼	iffy
聿	ifjm
法	ifko
溘	ifkw
潜	iflc
汐	ifo
沅	ifrp
汗	ifu
澍	ifua
澎	ifue
洁	ifvy
浅	igai
污	igap
漕	igbc
洹	igcg
沛	igeu
瀣	igfg
淑	igim
洌	igju
淖	iglu
汀	ignu
涞	igqo
添	igsx
浒	igth
沫	iguo
泸	igvi
沾	igvy
浈	igwo
滗	ihdz
渤	ihew
溲	ihjm
滚	ihkb
潮	ihlq
瀚	ihly
洧	ihqy
汁	ihu
滇	ihzk
渎	ihzs
浔	iiao
淌	iibv
挲	iidn
沙	iiei
当	iif
津	iifj
淼	iiiu
娑	iils
浸	iinm
隶	iipn
消	iiqy
肃	iirm
洮	iirp
鲨	iiws
裟	iiyb
淇	ijdk
湛	ijdz
满	ijgl
潇	ijir
凼	ijj
漠	ijjo
澌	ijkt
沏	ijmi
肀	ijmn
潆	ijni
滢	ijno
涝	ijnw
滥	ijtw
灌	ijul
柒	ijuo
漭	ijvm
懑	ijxo
油	ijy
泄	ijzp
渫	ijzu
湍	ikbj
浚	ikkp
浴	iklv
涔	iklz
汾	ikmi
湓	ikmw
滞	ikne
滏	iknu
渗	ikse
澄	iksu
汕	iku
治	ikvy
泔	iky
颏	ilbw
淦	ildu
潋	ilen
浍	ilgd
渝	ilgj
瀹	ilgw
沦	iljp
刻	ilju
亥	ilo
泠	ilpo
脊	ilqs
洽	ilsy
渐	iltt
染	iluo
沧	ilup
洳	ilvy
劾	ilwi
溆	ilxm
涂	ilxo
汝	ily
渖	imcj
淙	imdo
泽	imfj
浣	imfr
渲	imgg
演	imgk
泞	imgn
鸿	imhy
潢	imjk
沱	imjp
洪	imko
港	imku
汉	imo
涩	imop
淀	impo
潞	impv
粱	imqo
滨	imtk
滩	imtl
梁	imuo
沼	imvy
涫	imxy
江	imy
滓	imzh
泻	inag
溟	inch
浓	ineb
帚	inem
浠	inhe
淆	inhq
涵	inij
泷	inji
汹	inju
深	inku
浑	inlu
泾	inmy
汊	ino
溥	inqa
浦	inqy
沈	inrp
浙	intt
沉	inwp
沮	iny
濡	iobj
浪	ioco
洲	ioej
淳	ioey
灞	iojq
淤	iolm
濠	ionb
淡	iooo
灵	iop
游	iote
漩	iotp
沪	iovi
沩	iowo
酒	ioy
泳	iozi
涎	ipep
濒	ipew
洚	ipfj
涟	iplu
涉	ipne
泯	ipp
涌	ipqj
涤	ipuo
洛	ipvy
澹	iqbg
涣	iqbs
洵	iqcy
泖	iqer
肖	iqf
淝	iqip
削	iqjj
沟	iqko
婆	iqls
波	iqmo
溜	iqos
淘	iqrk
瀵	iqsk
洋	iqu
泡	iqup
浼	iqvr
涧	ircy
漂	irdo
润	irdy
滹	iren
鼗	irfh
湮	irfy
洙	irio
潭	irlu
滁	irlx
洗	irrp
溧	iruo
澜	irus
浩	irvy
泐	irwi
兆	irx
滤	irxo
洒	iry
汽	irzp
淹	iscz
淠	isgr
尜	isiu
溶	islv
氵	isnp
汰	isoo
渭	isqy
尖	isu
潦	isui
浃	isuy
泗	isy
漯	iszi
沲	itcp
氅	itdz
汔	itfp
雀	itlf
淮	itly
浜	itmk
濮	itmo
泺	ito
漉	itp
派	itqb
沂	ittu
海	itzo
沔	itzz
涕	iuan
渣	iucg
湟	iudy
溯	iueq
漾	iufi
泮	iuhu
淞	iukk
溢	iukw
漆	iuli
小	iun
沐	iuo
激	iuon
沭	iuoo
汜	iup
湔	iuqj
水	iut
淅	iutt
漤	iuul
淋	iuuo
潸	iuuq
漱	iuvl
濑	iuvw
涑	iuvy
湘	iuxy
泊	iuy
滋	iuzo
涡	ivbl
渑	ivcz
渥	ivdf
潺	ivee
涮	ivej
泥	ivjp
漏	ivoo
浞	ivpo
群	ivqv
涓	ivqy
郡	ivrv
敞	ivtn
澡	ivuu
漶	ivvx
溅	iwga
测	iwju
鋈	iwlu
没	iwmo
沃	iwo
沿	iwvy
渔	iwy
溷	ixbb
涠	ixdu
泌	ixei
渺	ixie
潲	ixiq
泅	ixlo
沤	ixno
沁	ixo
湫	ixoo
汇	ixp
瀛	ixqo
洇	ixso
濉	ixtl
河	ixu
渠	ixuo
洄	ixvy
泪	ixy
涸	ixyy
注	iyfy
汴	iygo
流	iyke
淬	iylh
鎏	iylu
浏	iynj
漓	iynk
汶	iyno
济	iynr
湾	iyoa
滦	iyou
澈	iyqn
湖	iyqy
液	iyto
滂	iyuo
滴	iyuy
沆	iywp
澶	iyxg
沽	iyy
濯	iyyl
泫	iyzo
沌	iyzp
澉	izbn
潼	izcf
渌	izfi
汛	izhu
漳	izlu
巴	izn
烫	izoo
泼	izpo
汤	izri
潍	iztl
涪	izvy
泣	izy
蘑	jaag
芎	jab
著	jacg
藏	jaej
葳	jael
茂	jaet
蒇	jaew
荛	jagr
蘼	jaid
蓍	jajc
艿	jbb
蓐	jbfa
苒	jbfg
茸	jbg
苤	jbgg
芮	jbly
芨	jboy
苋	jbrb
茼	jbsg
英	jbsy
苊	jbub
蕨	jbul
蕤	jbvd
苘	jbvg
顷	jbws
苈	jbwt
蒉	jbwy
茧	jby
莳	jcay
蕞	jcbm
菖	jccg
旨	jcd
旧	jch
匕	jcn
葱	jcox
萌	jcqg
葛	jcqz
蔓	jcsm
芴	jct
茛	jcy
觐	jdbr
蒜	jddy
苇	jdh
藉	jdic
藕	jdik
基	jdkf
綦	jdki
其	jdky
甚	jdkz
蓁	jdlx
葜	jdms
菁	jdqg
鄞	jdrf
勤	jdwd
菰	jedy
莩	jeeg
帅	jeej
师	jege
萜	jegv
芊	jehh
归	jeih
荪	jeiy
蔗	jejo
荽	jelg
莸	jenz
荻	jeoy
蕃	jeqs
菜	jeuy
藐	jevr
获	jevy
薛	jexh
芤	jezb
孽	jeze
蘖	jezu
艺	jfb
葑	jffa
芏	jfg
菱	jfkp
芙	jfly
芋	jfnh
芽	jfnt
莰	jfql
芫	jfrb
由	jft
苑	jfub
苹	jfut
蔷	jfuv
薹	jfvf
茗	jfvg
芜	jfzb
蕙	jgcx
蔼	jgcz
芸	jgdy
芾	jgeh
菽	jggm
薤	jgig
萋	jgil
凸	jgjg
葬	jgjm
廿	jgn
蔫	jgpo
莱	jgqy
茉	jguy
苫	jgvg
蚩	jhbp
鞅	jhbs
靼	jhcg
鞋	jhff
茑	jhg
鞲	jhgf
鸨	jhht
靶	jhia
鞘	jhiq
鞯	jhje
萸	jhly
鞴	jhmj
鞍	jhml
荸	jhne
艹	jhnp
茭	jhny
鞑	jhps
鞣	jhpu
鞫	jhqg
鞠	jhqq
鞔	jhqr
靴	jhtj
鞭	jhtn
靳	jhtt
若	jhvg
惹	jhvx
勒	jhwd
鞒	jhwr
芰	jhy
荨	jiay
芭	jib
颍	jibw
菲	jidg
藩	jies
萍	jifu
莎	jiie
萧	jiir
茳	jimg
薄	jina
菹	jing
蒲	jinq
蒗	jioc
落	jipv
菠	jiqm
蒎	jitb
范	jiub
藻	jivu
菏	jixh
蕖	jixu
茫	jiyz
荡	jizr
比	jja
暮	jjcg
萁	jjdk
摹	jjdn
葚	jjdz
幕	jjeh
墓	jjfg
毙	jjgj
毕	jjhh
芘	jjjb
荜	jjjh
蒈	jjju
茁	jjkh
屮	jjmn
刂	jjnp
蓦	jjsg
蓝	jjtw
皆	jjug
募	jjwt
毖	jjxe
慕	jjxy
莫	jjy
祟	jkdp
蔡	jkdy
苷	jkg
葵	jkgs
苡	jkly
出	jkmn
芬	jkmt
期	jkqg
欺	jkql
粜	jkqp
斯	jktt
苔	jkvg
蓊	jkyy
艽	jlb
薅	jlba
颟	jlbw
荃	jldg
荟	jlgd
莶	jlge
蔹	jlgn
草	jlh
苁	jlly
芄	jloy
苓	jlpy
芥	jlrh
苍	jlub
茶	jluy
茹	jlvg
荼	jlxy
菇	jlyg
芩	jlzb
菪	jmag
切	jmd
坚	jmff
蔻	jmfm
莞	jmfr
菀	jmfu
苎	jmg
萱	jmgg
荆	jmjf
凵	jmnp
肾	jmqf
茨	jmql
蓿	jmtc
苕	jmvg
贤	jmwu
菅	jmxg
竖	jmzf
紧	jmzi
萤	jnby
莹	jndo
蒋	jnfa
茔	jnfg
苴	jng
蒙	jngb
莺	jnhg
菡	jnij
蒸	jnio
荥	jniy
燕	jnjo
茏	jnjt
荤	jnlh
蓥	jnlu
茎	jnmg
茇	jnmy
菝	jnnm
丨	jnnp
荧	jnoy
莆	jnqg
荦	jnrj
荣	jnuy
营	jnvv
劳	jnwt
艾	jny
茕	jnzh
萦	jnzi
芳	job
薷	jobj
藁	jobu
蒿	jobv
莨	jocy
蓑	jogb
菸	jolm
葶	jonn
蕾	josg
藿	jotl
蘸	joto
蔟	jots
芦	jovt
苠	jpb
莛	jpef
芷	jpg
茈	jpjb
莲	jplh
蓬	jppj
蘧	jprb
芝	jpy
茅	jpzn
蓣	jpzw
荀	jqcg
茆	jqer
胄	jqf
茚	jqgr
萏	jqhg
蒌	jqlg
薮	jqln
芡	jqly
葡	jqnq
蒯	jqqj
菊	jqqy
萄	jqrk
菔	jqrm
莪	jqt
苞	jqub
藤	jqui
蔸	jqur
苟	jqvg
菟	jqvo
芍	jqy
芪	jrb
荇	jrfn
茜	jrg
节	jrh
茱	jriy
邮	jrj
薇	jrkn
蕈	jrlh
蓰	jrpp
荫	jrqg
蔺	jrtl
蘅	jrwn
萨	jrze
荑	jsab
薯	jsac
蔑	jsal
董	jscg
萘	jsdy
萝	jsfy
苗	jsg
鹋	jshg
肄	jsij
蓉	jslv
蕻	jsmk
薨	jsnj
甍	jsno
瞢	jsnx
疑	jspp
薰	jsso
荚	jsug
葸	jsxy
苌	jsy
苻	jtay
览	jtbr
擎	jtdn
荏	jtef
茌	jtfg
警	jtgg
花	jtjb
莜	jtjn
萑	jtlg
鹳	jtlh
蕉	jtlo
鉴	jtlu
颧	jtlw
劐	jtmj
临	jtod
芹	jtth
蘩	jtti
檠	jtuy
葆	jtvu
茯	jtvy
监	jtwf
荷	jtxh
七	jty
莅	jtzg
蓓	jtzv
莓	jtzy
蔽	jubn
蕲	juct
葭	jufm
萼	juga
苯	jugg
葩	juib
蒹	juio
蒴	jujq
菘	jukk
菥	jutt
蔌	juvl
葙	juxg
蕺	jvba
葺	jvbg
莴	jvbl
蔚	jvda
堇	jvdg
革	jvhh
莽	jvmh
荩	jvom
敬	jvtn
莒	jvvg
薜	jvvh
荐	jweg
茬	jwfg
萆	jwhh
蓟	jwjh
蓖	jwjj
苏	jwky
芟	jwmy
藓	jwqh
荞	jwrh
蒺	jwts
茄	jwvg
荔	jwww
莠	jxbb
颖	jxbw
苜	jxg
苛	jxh
莉	jxjh
萎	jxlg
藜	jxqi
蒽	jxsx
茵	jxsy
苣	jxug
茴	jxvg
蕊	jxxx
菌	jxxy
芯	jxy
芑	jyb
苦	jyg
苄	jygy
茺	jykr
萃	jylh
蓠	jynk
荠	jynr
葫	jyqg
蒂	jyue
蒡	jyuo
蓼	jyye
芒	jyzb
荒	jyze
蕹	jyzl
蓄	jyzs
戡	jzad
荮	jzay
世	jzbn
蕴	jzcw
薏	jzcx
芗	jzet
莘	jzhh
凹	jzjg
兕	jzjr
荭	jzmg
斟	jzmh
荬	jzms
蔬	jzpe
药	jzqy
薪	jzut
菩	jzvg
勘	jzwd
贳	jzwy
莼	jzyz
兮	kac
崴	kael
岩	kaf
屿	kagh
饶	kagr
崖	kbff
岸	kbfj
岗	kbnu
岌	kbou
岘	kbrm
视	kbrp
峒	kbsh
饵	kbt
蚀	kbw
馈	kbww
馄	kcjj
神	kcju
饣	kcnp
馒	kcsm
嵋	kcxh
祷	kdea
祭	kdi
禊	kdjs
饷	kebv
毵	kedz
饪	keft
馁	kelt
峙	kfal
刿	kfjj
祛	kfko
岈	kfnk
岁	kfu
禧	kfvv
社	kfy
饯	kgae
岍	kgmj
甘	kgn
崃	kgql
祆	kgso
癸	kgsp
祯	kgwo
馊	khjm
岐	khl
饽	khne
饺	khnw
炭	khou
巅	khzw
嵴	kilq
峭	kiqh
祧	kirp
岜	kiv
颛	kjbw
祺	kjdk
岿	kjei
岫	kjh
馍	kjjw
山	kjn
嵘	kjnu
崂	kjnw
熊	kjop
嶷	kjtp
馑	kjvd
颂	kkbw
瓮	kkgo
公	kki
垒	kkkf
峻	kkkp
峪	kklv
嵌	kkql
嶝	kksu
饴	kkvt
翁	kkyy
岭	klpl
嵛	klqj
崭	kltt
谷	klvd
以	klx
馀	klxw
岑	klzv
颁	kmbw
崇	kmdu
分	kme
坌	kmfd
峄	kmfj
岔	kmkk
弁	kmm
馓	kmqn
盆	kmwd
贫	kmwi
忿	kmxi
馆	kmxt
釜	kndu
带	kneh
爹	knff
崤	knhq
父	kni
爸	knic
辉	knlj
祓	knmo
爷	knrk
斧	kntt
祖	kny
嵩	kobv
崞	koeh
岬	koj
礻	konp
峰	kpdj
岷	kpm
厶	kpnp
皴	kpqm
嵬	kpu
祉	kpy
峋	kqch
饿	kqe
峁	kqer
嶙	kqfj
馅	kqht
峥	kqin
祢	kqio
能	kqjj
峨	kqk
嵝	kqlh
饮	kqlw
嵯	kqmh
馏	kqos
崩	kqqf
祥	kqu
饱	kquq
岣	kqvh
馋	kqvm
馐	kqzf
邯	krf
牟	krjm
崾	krlh
岚	krnu
祗	kroo
祁	kru
允	krz
饩	krzq
崦	kscz
叁	ksda
参	kseq
馕	ksjb
崆	ksmh
畚	kssa
福	kssy
登	ksua
峡	ksuh
凳	ksuw
崎	ksxj
崽	ksxu
饰	kter
屹	ktfm
祚	ktfy
崔	ktlf
饭	ktmw
矣	ktsp
祈	kttu
饬	ktwe
八	kty
馇	kucg
禅	kuch
禚	kufo
崧	kukk
饼	kumr
祀	kup
馔	kuuk
某	kuy
嵫	kuzo
台	kva
祸	kvbl
鹆	kvht
崛	kvjk
炱	kvop
欲	kvql
祝	kvrp
邰	kvrv
光	kvt
怠	kvxp
饥	kwq
峤	kwrj
饫	kww
岢	kxj
巍	kxlp
嵊	kxnj
岖	kxnl
岽	kxu
崮	kxyf
觊	kybr
岵	kyh
剀	kyjj
屺	kym
禳	kyub
岂	kyv
凯	kywm
祜	kyy
耀	kyyl
饨	kyzq
禄	kzfi
嶂	kzlj
礼	kzp
饧	kzre
饲	kzst
祠	kzsy
嬷	laek
娆	lagr
姥	lajz
轼	lamg
女	lat
姗	lbbg
娠	lbfb
轭	lbua
辋	lbuz
奶	lbz
辄	lbza
娼	lccb
旮	lcd
娌	lcfb
妲	lcgb
食	lci
辊	lcjj
辎	lcsg
旭	lct
媪	lcwb
媚	lcxb
她	lcz
全	ldd
婊	ldeb
轾	ldfg
佘	ldi
刽	ldjr
辏	ldls
鑫	ldlu
婧	ldqb
郐	ldrr
畲	ldsd
金	ldue
好	leb
姓	ledb
妊	lefb
媛	lefm
剑	lejr
嫒	lenm
敛	letn
轷	leun
媳	lexx
姊	lezn
轩	lff
娃	lffb
妹	lfix
嫱	lfuv
奸	lfv
辕	lfvb
舍	lfvd
嬉	lfvv
转	lfzo
妩	lfzz
辆	lgbl
会	lgdi
佥	lged
婕	lgip
龠	lgiw
娅	lgmb
媾	lgmf
妍	lgmv
嫣	lgpo
俞	lgqj
愈	lgqx
轳	lgvd
命	lgvr
嫂	lhjm
车	lhn
较	lhns
姣	lhnx
鸠	lht
妓	lhx
妇	lib
妙	liec
氽	lii
人	lin
姚	lirz
娉	ljaz
妯	ljb
仑	ljc
轴	ljg
媸	ljhb
嫫	ljjx
妣	ljjz
个	ljk
早	ljn
搴	lkdn
塞	lkfs
謇	lkgs
姒	lklx
寒	lkmo
骞	lkss
寨	lkuo
媒	lkux
始	lkvb
蹇	lkvp
赛	lkwo
褰	lkyb
轨	lla
耸	llbd
辁	lldg
轸	lled
坐	llfd
丛	llgd
输	llgj
轮	llja
众	llli
俎	llnt
从	llw
怂	llxi
妗	llzz
弩	lmaz
嫁	lmbb
胬	lmbl
婶	lmcj
仝	lmd
孥	lmea
姹	lmej
帑	lmem
娜	lmfr
婉	lmfu
辖	lmfy
辍	lmmm
轰	lmmy
轫	lmos
驽	lmsa
嫔	lmtk
轺	lmvg
努	lmwq
奴	lmx
怒	lmxp
姐	lnb
轻	lnmg
辅	lnqg
娘	locx
丸	loin
婷	lonn
孀	loux
妒	lovc
妫	lowo
妨	loz
领	lpbw
企	lpd
瓴	lpgo
令	lpi
邻	lprr
辂	lpvg
翎	lpyy
妤	lpzn
娥	lqc
辚	lqfj
觎	lqjr
毹	lqjz
软	lqls
娩	lqvr
妁	lqx
婚	lrcb
嫖	lrdx
姝	lrix
介	lrk
轶	lrls
娴	lrux
婀	lrxv
姨	lsaz
妈	lsb
颌	lsbw
合	lsd
拿	lsdn
鸽	lsht
龛	lsnj
辐	lssg
嫦	lsve
盒	lswd
翕	lsyy
嫘	lszi
辘	lta
暂	ltcg
堑	ltfg
錾	ltlu
轹	lts
斩	lttf
椠	ltuy
九	lty
戗	luae
娣	luan
仓	luc
婵	luch
馗	luex
杂	lui
嫌	luio
伞	lujk
创	lujr
姘	lumv
嫩	luvn
如	lvb
辑	lvbg
娲	lvbl
颔	lvbw
娓	lvdz
軎	lvg
娱	lvgs
妮	lvjz
轵	lvks
辗	lvmb
舒	lvpn
娟	lvqb
恕	lvxp
絮	lvzi
墼	lwfg
婢	lwhv
媲	lwnj
轿	lwrf
娇	lwrv
嫉	lwts
妖	lwx
轲	lxf
余	lxi
姬	lxjj
斜	lxmh
叙	lxmw
妪	lxnx
姻	lxsx
姑	lyb
轱	lyg
禽	lynk
辙	lyqn
嫡	lyuy
嬗	lyxg
歙	lyyl
妃	lyz
轧	lza
今	lzc
妞	lzfb
嫜	lzlv
婿	lzpq
含	lzvd
贪	lzwi
姆	lzx
念	lzxi
衾	lzyb
巧	maa
戏	mac
减	maes
跷	magr
跖	mah
守	mao
宕	mas
对	max
怼	maxp
跚	mbbg
宸	mbfb
凋	mbfv
蹑	mbmm
寡	mbnm
趿	mbol
观	mbrz
蹰	mbsa
蹶	mbul
家	mbvb
项	mbws
寓	mcbk
踢	mcck
昔	mcg
鹊	mchg
审	mcjl
跟	mcl
宴	mcls
踝	mcul
艰	mcx
躐	mcxo
蹋	mcyy
踌	mdea
室	mdfs
凑	mdls
宗	mdo
宝	mdoo
躔	mecf
踮	megv
蹈	mehh
踱	mejm
宅	mejx
蹯	meqs
字	mes
踩	meul
踽	mevk
蹊	mezs
圣	mfa
跬	mffh
凌	mfkp
趺	mfll
业	mfn
宇	mfnl
寇	mfrm
那	mfrv
完	mfrx
剜	mfuj
宛	mfux
害	mfys
践	mgak
宣	mgcg
寂	mggm
凄	mgil
寅	mgjk
冽	mgju
踔	mglj
趼	mgmj
宁	mgnl
工	mgt
冱	mgzy
鸡	mhb
宏	mhko
斗	mhl
跤	mhnl
廾	mhnp
宥	mhqs
踏	mich
黻	minm
黼	minq
冰	mio
宵	miqs
跳	mirm
汞	miy
躇	mjac
宽	mjbr
蹒	mjgl
卅	mjhn
跸	mjjh
寞	mjjo
黄	mjky
躏	mjrl
宙	mjs
凝	mjsp
它	mjx
蹀	mjzu
踹	mkbj
察	mkdo
趴	mkl
蹦	mkqq
蹬	mksu
巷	mkub
跆	mkvh
冶	mkvy
恭	mkxy
共	mky
觋	mlbr
巫	mlly
冷	mlpo
安	mls
跄	mlum
案	mluo
宄	mlx
踪	mmdl
跎	mmjm
叠	mmmn
桑	mmmu
蹼	mmqo
实	mmso
颡	mmuw
双	mmx
寐	mnbi
寤	mnbv
寝	mnim
宠	mnjw
跋	mnml
宜	mns
踉	mocl
躞	mogm
凉	moio
蹴	moiz
灾	moo
刃	mop
蹁	movw
忍	moxp
跹	mpeh
趾	mph
鹭	mphf
踺	mpij
又	mpn
定	mpo
踊	mpqj
路	mpvh
客	mpvs
蹂	mpzu
跪	mqbu
瓷	mqgo
净	mqin
趵	mql
次	mqlo
姿	mqls
欢	mqlx
蹉	mqmh
跛	mqml
刀	mqn
粢	mqqo
散	mqtn
跑	mqum
咨	mqvs
资	mqwo
盗	mqws
恣	mqxo
邛	mrf
邺	mrj
牢	mrjl
跌	mrll
跣	mrrm
冼	mrrp
躜	mrrw
宪	mrrx
邓	mrv
踵	msch
跨	msga
冫	msnp
头	mso
躅	msqb
寰	mssb
富	msss
寮	msui
蹿	msvj
寄	msxl
冯	msy
跗	mtal
宿	mtbc
踬	mthw
跞	mtl
难	mtlb
准	mtly
宾	mtmk
攻	mtns
踟	mtsv
〇	mty
黹	mubi
蹭	mudc
凿	muhj
凇	mukk
宋	muo
蹲	muoa
踯	musr
召	mva
额	mvbw
冲	mvju
况	mvrp
邵	mvrv
躁	mvuu
宫	mvvs
劭	mvwc
踞	mvyh
蛩	mwby
劝	mwc
功	mwd
跃	mwl
銎	mwlu
巩	mwos
跺	mwul
跏	mwvh
跫	mwvp
恐	mwxy
贡	mwy
蜜	mxeb
密	mxek
宓	mxew
宦	mxjj
宀	mxnp
冻	mxo
甯	mxqj
官	mxs
距	mxuh
割	myju
豁	mykv
跻	mynr
蹄	myue
凛	myxd
跽	myxl
寥	myye
宰	mzhl
决	mzso
踣	mzvh
拷	naaa
找	nad
撼	naex
拓	nag
挠	nagr
写	nags
拭	namg
搦	namm
拂	narf
捂	navg
扔	nba
戕	nbac
振	nbfb
捱	nbff
摄	nbmm
蚤	nbp
爿	nbq
揶	nbrf
扼	nbua
撅	nbul
冢	nbvb
撮	ncbm
捍	ncff
捏	ncfg
拶	ncfs
担	ncgg
冥	ncho
拽	ncjd
抻	ncjf
提	ncps
揭	ncqz
承	ndip
捧	ndlj
揍	ndls
搬	ndwm
撬	ndzz
捋	neas
农	nebo
扩	ned
援	nefm
掂	negv
扦	nehf
插	nehh
搪	neiv
托	neja
摭	nejo
授	nenm
搅	nenr
欷	neql
播	neqs
摇	nerk
郗	nerr
抓	nes
擤	nexr
括	neyg
将	nfao
持	nfas
挂	nffg
浆	nfio
撵	nfll
扶	nfls
酱	nfos
冠	nfra
奖	nfso
奘	nfsp
且	nft
抨	nfud
桨	nfuo
拮	nfvg
撷	nfvw
壮	nfy
装	nfyb
抚	nfza
抟	nfzo
孑	ngan
捷	ngip
掉	nglf
打	ngnf
扌	ngnp
扑	ngs
掭	ngsx
抹	ngus
拈	ngvg
希	nhek
搜	nhjm
捣	nhkf
擀	nhlf
肴	nhqd
技	nhs
攥	nhxi
把	nia
排	nidg
抄	nied
捃	niev
扫	nig
丞	niga
卺	nigu
挡	niig
函	nijm
捎	niqg
挑	nira
救	nitn
求	niy
裘	niyb
砻	njag
聋	njbg
指	njcg
幂	njel
垄	njfg
抽	njg
批	njja
摸	njjs
揩	njju
鬯	njjx
凶	njk
拙	njkf
撕	njkt
搭	njls
搽	njlu
北	njm
龚	njmk
捞	njnw
背	njqf
刈	njr
邶	njrj
描	njsg
冀	njsk
龙	njt
揽	njtr
袭	njyb
揲	njzu
揣	nkbj
罕	nkfl
揆	nkgs
拟	nkls
扮	nkmd
拚	nkmf
郄	nkrr
扒	nks
掺	nkse
摧	nktl
挨	nkts
县	nku
抬	nkvg
悬	nkxu
蛰	nlby
拴	nldg
挚	nldn
垫	nlfg
捡	nlge
揄	nlgj
鸷	nlhg
鹤	nlhy
抡	nlja
军	nll
挫	nllf
丬	nlnp
执	nlos
热	nloy
拎	nlps
皲	nlqm
郓	nlru
拾	nlsg
抢	nlua
抛	nlwd
势	nlwt
贽	nlwy
妆	nly
擒	nlyk
絷	nlzi
捻	nlzx
颈	nmbw
措	nmcg
择	nmfj
挪	nmfr
扛	nmg
揎	nmgg
拧	nmgn
抖	nmhf
刭	nmjv
擦	nmkd
拱	nmks
按	nmlg
掇	nmmm
搡	nmmu
了	nmn
撒	nmqn
摈	nmtk
摊	nmtl
招	nmvg
劲	nmwc
巯	nmye
搔	nnbs
爻	nni
拯	nnig
拢	nnjd
探	nnku
挥	nnlf
拔	nnms
搏	nnqa
捕	nnqg
扰	nnza
搞	nobv
押	nof
掠	nois
孓	nopn
擂	nosg
攉	notl
敷	notn
护	novd
掮	novq
捩	novv
抿	npa
挝	npas
挺	npef
扯	npg
叉	npn
捅	npqj
挞	npss
抒	npzn
揉	npzu
换	nqbs
甫	nqgn
掐	nqhg
挣	nqin
拥	nqjf
搂	nqlg
擞	nqln
搓	nqmg
披	nqms
掬	nqqs
抑	nqrf
掏	nqrk
抱	nqua
拘	nqvg
搀	nqvm
冤	nqvo
挽	nqvr
扪	nra
鸩	nrhy
报	nrms
抵	nros
搁	nrpv
攒	nrrw
掳	nrwd
摅	nrxs
掩	nscz
捺	nsds
挖	nsfa
摆	nsfk
挎	nsga
攮	nsjb
捶	nsjf
控	nsmg
撂	nspv
擐	nssb
挟	nsug
撩	nsui
撺	nsvj
撑	nsvn
掎	nsxf
摞	nszi
拊	ntas
蜇	ntby
拖	ntca
誓	ntgg
携	ntlb
推	ntlg
雎	ntlh
扳	ntms
收	ntnx
搋	ntrw
折	nttf
掀	nttl
拆	ntto
哲	ntvg
踅	ntvp
弑	nuam
揸	nucg
掸	nuch
搠	nueq
拦	nufg
拍	nug
拌	nuhf
杀	nui
撇	nuin
搛	nuio
刹	nujr
拼	numf
撙	nuoa
掷	nusr
撰	nuuk
揖	nvbg
握	nvdf
扣	nvg
挹	nvia
掘	nvjk
搌	nvmb
亟	nvmg
状	nvo
捉	nvps
捐	nvqg
摒	nvum
操	nvuu
擗	nvvh
拐	nvwd
捌	nvwj
损	nvws
据	nvyg
撸	nwcg
捭	nwhf
助	nwk
投	nwms
挢	nwrf
撄	nwwl
冗	nwx
揠	nxcl
掴	nxdo
冖	nxnp
抠	nxns
揪	nxos
拣	nxs
摁	nxsx
拒	nxug
捆	nxus
攫	nxxm
拄	nyfg
摔	nyih
挤	nynr
揿	nyql
撤	nyqn
掖	nyto
攘	nyub
摘	nyuy
抗	nywa
擅	nyxg
擢	nyyl
摺	nyyu
搐	nyzs
扎	nza
尤	nzb
撖	nzbn
撞	nzcf
揞	nzcg
掾	nzeb
扭	nzfg
拉	nzg
掼	nzhw
接	nzlg
拗	nzow
拨	nzpo
扬	nzrd
拇	nzs
抉	nzss
掊	nzvg
烤	oaap
酵	oaeg
烧	oagr
酎	oas
焐	oavy
炻	oay
需	obbj
震	obfb
醴	obmu
烛	obo
酮	obsg
高	obvs
炯	obvy
烦	obwo
雳	obwt
酏	oca
醒	oced
焊	ocfu
醌	ocjj
爆	ocmi
良	oco
醍	ocps
朗	ocqy
郎	ocru
熳	ocsm
煜	oczy
炜	odu
酹	oeas
哀	oebo
燠	oebs
鹑	oehy
醣	oeiv
孰	oelo
州	oeoj
燔	oeqs
郭	oeru
享	oes
爝	oesa
敦	oetn
烀	oeun
霾	oevf
熄	oexx
酐	off
酩	ofvg
灶	ofy
雩	ogab
炳	ogbl
酾	ogbo
霭	ogcz
酝	ogds
衰	ogeb
焯	oglu
酽	ogme
酉	ogn
酊	ognf
灯	ognu
燮	ogom
鸭	ohh
霓	ohrb
醢	ohvw
霏	oidg
霪	oief
炒	oiei
雪	oig
霈	oige
就	oinz
京	oio
霄	oiqg
酃	oirf
颥	ojbw
酯	ojcg
衷	ojeb
醛	ojld
甲	ojn
霸	ojvq
酣	okg
酸	okkp
酚	okmd
灿	oku
煤	okuo
塾	olfs
烩	olgd
於	olmo
熟	oloo
零	olpy
炝	olup
酴	olxs
焓	olzv
醋	omcg
烷	omfr
煊	omgg
酡	omja
烘	omko
露	ompv
霰	omqn
醭	omqo
豪	onbb
毫	ondz
亳	onej
亭	ongn
烯	onhe
鹫	onhs
酗	onjf
亨	onl
烃	onmy
丶	onnp
义	ono
烹	onoo
膏	onvq
亮	onwx
酿	oocs
醇	ooeg
酬	ooej
剡	ooju
火	oon
灬	oonp
炎	ooo
焱	oooo
郯	ooru
炉	oovi
煸	oovw
煽	oovy
煺	opco
烽	opdj
霆	opef
醚	opqs
燧	opub
酪	opvg
烙	opvy
雾	opwt
焕	oqbs
焰	oqhy
炊	oqlo
燃	oqmo
灼	oqo
熘	oqos
酌	oqs
烊	oqu
雹	oqub
炮	oqup
醵	orbb
旆	oreu
酰	orra
邡	oru
酷	orvg
焖	orxo
雷	osg
煨	osgb
熔	oslv
酞	osos
醺	osso
燎	osui
旃	otby
施	otcp
煅	otdm
旄	otdz
旌	oted
酢	otfg
炸	otfy
肇	otij
烨	otjh
旗	otjk
霍	otlg
醮	otlo
放	otno
烁	oto
旅	otqb
膂	otqs
旖	otsx
族	otts
旎	otvj
憝	otxo
旒	otye
綮	otzi
旋	otzp
酶	otzs
霉	otzy
煌	oudy
霞	oufm
烂	oufy
霖	ouuy
霜	ouxg
扃	ovbv
酲	ovdg
敲	ovgm
扉	ovid
炽	ovko
戽	ovmh
烬	ovom
房	ovox
肩	ovqs
雇	ovtl
燥	ovuu
霹	ovvh
扈	ovvi
戾	ovvo
启	ovvs
户	ovw
扁	ovwl
扇	ovyy
为	owoo
翩	owyy
炼	oxo
酥	oxs
烟	oxso
方	oxt
炬	oxuy
配	oya
炷	oyfy
酤	oyg
醯	oykw
醉	oylh
雨	oyn
霁	oynr
雯	oyny
醐	oyqg
煳	oyqy
熵	oyuv
炕	oywp
醪	oyye
熠	oyyu
炫	oyzo
炖	oyzp
昶	ozic
永	ozio
霎	ozlg
醑	ozpq
炀	ozri
炔	ozso
醅	ozvg
焙	ozvy
过	pao
还	pbgo
魍	pbuz
逐	pbvb
迥	pbvy
颦	pbwh
遗	pbwo
遣	pbxy
遇	pcbk
退	pco
巡	pcp
遏	pcqz
暹	pctl
邋	pcxo
遢	pcyy
遨	pdqn
违	pdu
频	pebw
逛	pedy
廷	pefb
迁	pehu
逊	peio
遮	pejo
逖	peoo
延	pepz
遥	perk
邈	pevr
追	pexy
适	peyy
魅	pfiw
逵	pfkf
止	pfn
迓	pfni
迂	pfnu
远	pfrp
进	pfru
遭	pgbc
魉	pgbl
逦	pgbo
昝	pgcd
运	pgdo
遘	pgmf
迈	pgqp
咎	pgvd
处	pgw
歧	phl
建	pifj
逮	piio
鬼	pin
夂	pinp
魈	piqt
逍	piqy
逃	pirp
砦	pjaf
龉	pjav
龈	pjcl
龋	pjek
些	pjff
訾	pjgf
龀	pjjm
龄	pjlp
此	pjm
龆	pjmv
龃	pjnh
龇	pjpj
觜	pjqj
龅	pjqu
雌	pjtl
柴	pjuu
龌	pjvf
龊	pjvp
赀	pjwu
迪	pjy
紫	pjzi
遄	pkbj
逡	pkkp
迨	pkvy
逾	plgj
齿	pljj
连	plu
途	plxo
螽	pmbb
魁	pmhr
冬	pmi
迢	pmvy
逭	pmxy
预	pnbw
步	pner
逑	pnio
矜	pnlz
魃	pnmw
迳	pnmy
豫	pnqb
逋	pnqy
逝	pntt
辽	pnu
之	pon
辶	ponp
遍	povw
逢	ppdj
逄	ppfj
廴	ppnp
通	ppqj
肯	pqf
遴	pqfj
迩	pqio
甬	pqjm
勇	pqjw
恿	pqjx
迷	pqo
遛	pqos
邂	pqqj
迎	pqru
逸	pqvo
遽	prbb
迭	prlo
选	prrp
造	prvy
备	psd
逻	psfo
达	pso
逼	pssy
邃	psub
逗	psuy
惫	psxi
蝥	ptbp
迤	ptcp
迄	ptfp
迮	ptfy
鹜	ptha
迕	pthu
遁	pthx
婺	ptla
鍪	ptlu
返	ptmo
骛	ptsa
逅	ptsy
近	pttu
瞀	ptxa
愍	ptxp
递	puan
遑	pudy
遂	pueb
道	puex
遐	pufm
条	pui
逆	puje
迸	pumu
遵	puoa
邀	puon
述	puoo
遒	puoy
送	puso
速	puvy
迫	puy
各	pvd
逞	pvdy
鹬	pvhb
迟	pvoo
雒	pvtl
避	pvvh
务	pwe
边	pwi
迦	pwvy
透	pxbp
逶	pxly
魑	pynk
这	pyno
迹	pyoo
蟊	pzbb
逯	pzfi
迅	pzhu
予	pznm
矛	pznq
柔	pznu
民	pzt
腻	qafw
糨	qavb
肘	qaw
胚	qbgg
粝	qbgq
詹	qbkg
肭	qblw
腆	qbmk
奂	qbsi
胴	qbst
危	qbuc
豚	qbvb
腼	qbxf
旬	qcd
腥	qced
胆	qcgt
胂	qcjr
勹	qcnp
羯	qcqz
郇	qcrr
腽	qcwt
龟	qczc
腠	qdls
月	qdn
腈	qdqt
精	qdqy
胍	qdw
卿	qecr
胜	qedt
肜	qee
脬	qeet
脏	qeft
糠	qeii
糖	qeiv
我	qen
卯	qerr
腑	qeta
臁	qeuo
糗	qexv
籽	qey
粼	qfjv
脚	qfkr
肤	qflw
肝	qfr
朊	qfrq
肼	qfrr
肚	qft
膨	qfue
臌	qfuh
肟	qgaq
糟	qgbc
粳	qgcn
訇	qgd
肺	qger
胩	qggg
印	qgrr
胪	qgve
粘	qgvy
腩	qhbh
肱	qhkw
腴	qhlw
脖	qhne
胶	qhnw
鹅	qht
肢	qhw
色	qic
刍	qid
玺	qido
腓	qidt
尔	qii
胲	qilw
勺	qin
争	qink
粑	qip
肥	qiq
皱	qiqm
邹	qirr
雏	qitl
急	qixi
触	qjbw
脂	qjct
觚	qjdw
膜	qjjw
用	qjkn
觥	qjkq
斛	qjmh
解	qjmj
朦	qjnb
刖	qjr
觞	qjtr
觯	qjuh
觫	qjuv
觖	qjzs
羰	qkho
勾	qki
羧	qkkp
粉	qkmi
胱	qkq
糁	qkse
籼	qku
胎	qkvt
胗	qlee
脍	qlgd
脸	qlge
腧	qlgj
欠	qli
脞	qllf
羊	qln
羚	qlpo
娄	qls
数	qltn
蟹	qmbi
颇	qmbw
腊	qmct
匀	qmd
粽	qmdo
腙	qmdw
脘	qmfr
腕	qmfu
料	qmhu
粪	qmko
胺	qmlt
炙	qmoi
皮	qmp
腚	qmpw
差	qms
留	qmsd
肛	qmt
膑	qmtk
贸	qmwi
脓	qneb
胧	qnje
匈	qnjk
胫	qnmt
羟	qnmy
膊	qnqa
匍	qnqd
脯	qnqt
脎	qnuw
粗	qny
糯	qobj
粮	qoco
久	qoi
灸	qooi
肪	qoq
胛	qor
孵	qore
养	qorl
卵	qoro
米	qot
脉	qozi
腿	qpcw
糌	qpgc
腱	qpij
糙	qprv
胳	qpvt
糅	qpzu
脆	qqbu
膦	qqfj
鹏	qqht
角	qqjk
肷	qqlw
胸	qqnj
朋	qqt
胞	qquq
膳	qquv
朐	qqvt
脒	qqw
膘	qrdw
腰	qrlt
服	qrmw
羝	qroo
胝	qrow
粞	qry
胰	qsaq
膈	qsbj
腌	qscz
甸	qsd
膣	qsdf
胯	qsga
腔	qsmt
类	qso
肽	qsow
匐	qssd
膛	qsvf
胀	qsw
腮	qsxw
腹	qtcp
胙	qtft
敉	qtno
煞	qtoi
糇	qtzs
包	quc
糕	qufo
腭	quga
胖	quhr
腺	quiw
刨	qujr
膝	quli
胼	qumr
塍	qusf
滕	qusi
媵	qusl
腾	quss
朕	qusw
兜	quur
脱	quvr
善	quvs
粕	quy
糍	quzo
脶	qvbl
句	qvd
象	qveb
够	qvff
鸲	qvht
脲	qviw
肿	qvjr
然	qvoi
免	qvrc
兔	qvro
鄯	qvru
勉	qvrw
臊	qvuu
劬	qvwe
肋	qwe
脾	qwhr
负	qwi
胁	qwkw
股	qwmw
肌	qwq
着	qxs
胭	qxsw
胨	qxw
粹	qylh
脑	qynj
脐	qynr
糊	qyqy
腋	qyto
膀	qyuo
膪	qyuv
肮	qywq
膻	qyxg
翔	qyyy
臃	qyzl
肫	qyzq
甩	qzcn
臆	qzcx
羞	qzfs
糈	qzpq
肠	qzre
断	qztt
羌	qzx
粒	qzy
阈	ravg
衙	ravn
陌	rbcb
陬	rbmx
闽	rbo
闻	rbs
阳	rcb
隅	rcbk
阊	rccs
昏	rcd
陧	rcfb
得	rcga
氏	rcn
间	rcs
很	rcw
限	rcx
隰	rczo
瓢	rdds
剽	rdjf
闱	rdl
飘	rdrn
闰	rds
闫	rdsn
际	rdx
票	rdy
阡	rehv
制	rejr
阌	renm
徭	rerk
待	rfaw
街	rffn
闺	rffs
甄	rfgo
陵	rfkp
陆	rfkv
阖	rfkw
行	rfnr
徒	rfpw
陡	rfpx
鄄	rfrf
阱	rfrv
阮	rfrz
卫	rga
陋	rgbz
夙	rgi
闭	rgnw
征	rgpt
徕	rgqw
阢	rgrz
闩	rgs
西	rgt
阽	rgvb
惩	rgxi
堕	rhfa
闳	rhko
隳	rhlx
隋	rhmq
阋	rhrx
德	rhsx
阗	rhzk
徜	ribv
隙	rici
徘	ridt
阔	riey
律	rifj
衍	rifn
愆	rifx
朱	riin
阂	rilo
陔	rilx
邾	rirr
牾	rjav
顺	rjbw
物	rjce
掣	rjdn
牦	rjdz
牲	rjed
特	rjfa
牡	rjft
犊	rjhs
陛	rjjf
牝	rjjq
牛	rjkn
彻	rjme
犒	rjov
犏	rjow
犍	rjpj
川	rjr
牺	rjrt
牿	rjrv
犄	rjsx
牧	rjtn
牯	rjyt
犋	rjzk
徵	rkdn
阕	rkgs
徽	rkin
罐	rkjl
缶	rkkn
缸	rkmt
彳	rknp
罅	rkrn
微	rkwn
缺	rkzs
坠	rlfa
舞	rlfj
要	rlg
险	rlge
覃	rlh
失	rlin
闪	rlo
阶	rlrv
阵	rlv
队	rlx
徐	rlxw
除	rlxx
觑	rmbr
虚	rmf
院	rmfr
凤	rmi
陀	rmjz
阝	rmn
卩	rmnp
阻	rnb
飕	rnhm
风	rni
陇	rnjc
陉	rnmb
径	rnmt
飚	rnoo
飑	rnqu
徂	rnt
飓	rnzk
阆	roco
鸱	roht
氐	roi
闸	rol
阏	rolm
彷	roq
邸	rorr
防	roz
降	rpfj
隆	rpgd
随	rphq
陟	rpne
徙	rppw
卸	rprr
骘	rpsa
闼	rpso
隧	rpub
阁	rpvs
隗	rpx
阴	rqb
徇	rqct
阄	rqcz
陷	rqhb
阎	rqhs
隐	rqix
彼	rqmw
陂	rqmx
儿	rqn
徉	rqr
陶	rqrk
粟	rqy
先	rrc
阍	rrcs
御	rrpr
覆	rrtp
赞	rrwi
隔	rsbj
阉	rscz
隈	rsgb
陲	rsjv
闯	rss
陕	rsub
阀	rtaw
附	rtax
阼	rtfb
循	rthx
阪	rtmx
阐	ruch
隍	rudb
凰	rudd
徨	rudt
鹇	ruhy
阙	rujl
隘	rukw
闲	ruo
徼	ruon
阑	russ
阅	ruvr
栗	ruy
告	rvd
虞	rvgs
鹄	rvht
靠	rvid
虍	rvnp
郜	rvrr
问	rvs
闾	rvvs
陨	rvwx
彪	rwek
陴	rwhv
衡	rwln
役	rwmw
虏	rwr
虎	rwv
贾	rwy
虐	rxgf
衢	rxln
门	rxn
闷	rxo
虑	rxu
阃	rxuo
阿	rxv
阒	rxvo
徊	rxvt
陈	rxx
闹	ryel
衔	ryfn
往	ryft
闵	ryno
虔	rynu
闶	rywx
氟	rzar
氖	rzbc
阚	rzbn
气	rzc
氲	rzcw
氰	rzdq
氕	rzee
氩	rzgm
氦	rzil
氙	rzkk
氛	rzkm
障	rzlv
氨	rzml
氢	rznm
氮	rzoo
後	rzop
氡	rzpm
氧	rzqk
氚	rzrj
氘	rzrk
陪	rzvb
氤	rzxs
氪	rzyr
氯	rzzi
夷	sabn
署	sacf
奢	sacg
瓠	sads
骁	sagr
刳	sajf
匏	saqu
马	sat
穹	sax
夺	say
耷	sbg
罘	sbgu
骤	sbmt
鬲	sbuj
重	scdn
罹	sctl
窠	scuo
骒	scux
驰	scz
奄	sczb
窳	sddo
畴	sdea
窒	sdfs
奈	sdy
髯	sebf
鬣	seco
髟	sed
髦	sedz
髻	sefv
髡	segr
帘	sel
鬃	semd
鬓	semk
髫	semv
髭	sepj
窆	sepo
鬟	sesb
髹	setu
鬈	seuu
鬏	sexo
奎	sffg
畦	sffh
罴	sfko
罢	sfku
窥	sflr
田	sfn
穿	sfnw
穸	sfo
墨	sfof
黑	sfou
罗	sfu
夸	sgab
骊	sgbo
畏	sgbu
尝	sgdu
詈	sgf
罚	sgjj
罩	sglj
町	sgnj
罡	sgpf
畀	sgrj
罱	shbh
奔	shmh
置	shzf
窦	shzs
罪	sidf
窘	siev
肆	sifj
鹩	sihg
骇	silx
长	sin
事	sinh
窕	sirx
骋	sjaz
蠹	sjbb
融	sjbs
骐	sjdk
毗	sjjm
垂	sjkn
窃	sjmw
囊	sjnb
橐	sjnu
羁	sjvs
翮	sjyy
骏	skkp
骖	skse
骀	skvb
畛	slek
验	slge
窬	slqj
界	slrj
容	slvs
究	slx
窍	smax
驿	smfj
畹	smfu
驼	smjz
空	sms
驭	smx
驵	snb
骚	snbx
骥	snjk
爽	snnn
驳	snnx
牵	snrj
吏	snyn
黟	soff
黠	sofv
黩	sohs
黜	sojk
黪	soke
黢	sokp
黔	solz
穴	son
黥	sooi
驴	sovc
默	sovl
骗	sovw
骟	sovy
态	soxy
太	soy
黯	sozc
黝	sozw
骆	spvb
略	spvh
蜀	sqbu
胃	sqf
驺	sqib
窭	sqls
骝	sqos
驹	sqvb
骠	srdx
夼	srjh
驯	srjv
窑	srkl
窿	srpd
窖	srvs
驷	ssb
罨	sscz
奋	ssg
副	ssjf
熏	ssoi
驮	ssx
畸	ssxj
骑	ssxv
套	ssy
骡	sszi
驸	stax
窄	stfs
骅	stjh
骓	stlb
畈	stml
畋	stnl
四	sty
颊	subw
罾	sudc
豆	sug
夹	sugn
畔	suhj
豉	suhs
豇	sumg
豌	sumu
骈	sumv
郏	surf
窝	svbl
掌	svdn
骣	svee
常	svej
堂	svff
窟	svjk
畎	svl
驶	svnx
突	svo
党	svrv
棠	svuu
窜	svvj
赏	svwu
裳	svyb
嬲	swlw
窗	swpo
骢	swpx
男	swr
骄	swrv
夯	swt
穷	sww
奇	sxh
剞	sxjf
驱	sxnx
奁	sxny
欹	sxql
思	sxu
罟	syf
驻	syfb
大	syn
骧	syub
窀	syzx
疃	szcf
窨	szcs
鹌	szhg
累	szoi
窈	szow
伐	tae
垡	tafd
侥	tagr
佬	tajq
岱	takk
代	taq
牮	tarj
佛	tarr
黛	taso
伍	tat
付	taw
贷	tawi
袋	tayb
佰	tbct
倜	tbfv
仍	tbq
侗	tbst
佴	tbt
偶	tcbk
倡	tcct
俚	tcft
但	tcgt
伸	tcjr
偬	tcox
复	tcpi
他	tcq
偈	tcqz
倮	tcuw
俦	tdea
倒	tdfj
侄	tdft
傣	tdli
俸	tdlj
傲	tdqn
倩	tdqt
伟	tdr
仨	tdt
段	tdwm
债	tdww
俘	teet
任	teft
仟	tehr
仫	tekw
仔	tet
俯	teta
凭	tewc
赁	tewi
恁	texi
侍	tfaw
乞	tfc
乍	tfd
佳	tfft
侈	tffw
佞	tflt
伢	tfne
亿	tfq
僭	tfrc
仁	tft
仕	tftn
佶	tfvt
僖	tfvv
怎	tfxi
传	tfzo
储	tgac
俩	tgbl
俪	tgbo
便	tgcn
佧	tggg
例	tgjr
倬	tglr
俨	tgme
仃	tgnr
仗	tgnw
僵	tgsg
信	tgt
卮	tguc
仆	tgw
侦	tgww
佤	tgzo
偾	thjw
午	thk
佐	thmt
佼	thnw
侑	thqt
什	thr
倪	thrq
佑	thvt
伎	thw
质	thwi
盾	thxd
值	thzt
倘	tibv
俳	tidt
伊	tiee
侵	tinm
俏	tiqt
佻	tirq
乐	tit
俜	tjaq
倾	tjbw
麒	tjdk
华	tjhk
偌	tjhv
仳	tjjq
偕	tjju
修	tjpe
倏	tjpv
化	tjq
攸	tjtn
悠	tjtx
儆	tjvn
货	tjwi
候	tjzs
傺	tkdw
俊	tkkp
俗	tklv
似	tklw
份	tkme
亻	tknp
佾	tkqt
仙	tkr
侔	tkrj
催	tktl
俟	tkts
隽	tlbc
鏖	tldu
侩	tlgd
俭	tlge
偷	tlgj
雠	tlgl
隼	tlhk
伦	tljq
鹪	tloh
焦	tloi
劁	tloj
伶	tlpw
仇	tlq
价	tlrr
隹	tlt
集	tlui
伧	tluq
售	tlvd
借	tmct
丘	tmd
乒	tmee
伫	tmgt
反	tmi
佗	tmjq
兵	tmki
岳	tmkk
供	tmkw
乓	tmoi
仞	tmow
邱	tmrr
傧	tmtk
傩	tmtl
仅	tmw
倌	tmxt
侬	tneb
攵	tni
俅	tniw
傅	tnqa
优	tnzq
儒	tobj
僦	toiz
停	tonn
仪	tonw
仿	toq
偏	tovw
伙	tow
伪	towo
健	tpij
佟	tpmw
俑	tpqj
傀	tpw
儋	tqbg
俄	tqe
麟	tqfj
你	tqiw
佣	tqjr
偻	tqlt
麋	tqo
佯	tqr
仰	tqrr
像	tqvb
佝	tqvt
您	tqxi
佩	trge
侏	triw
件	trjr
佚	trlw
低	trow
们	trq
僳	trqw
傈	truw
矧	tsaj
俺	tscz
后	tsd
侉	tsga
偎	tsgb
偿	tsgd
矢	tsi
矬	tslf
倥	tsmt
使	tsnw
儇	tssb
儡	tsss
短	tssu
佃	tst
雉	tstl
僚	tsui
侠	tsut
傥	tsvr
知	tsvt
伥	tsw
矫	tswr
矮	tsxl
倚	tsxr
矩	tsxu
颀	ttbw
仡	ttfq
作	ttft
仵	tthr
斤	ttk
僬	ttlo
斥	ttoi
欣	ttql
鳘	ttwd
伤	ttwe
繁	ttzi
侮	ttzw
僧	tudc
假	tufm
体	tugt
伴	tuhr
鸺	tuht
倦	tusu
伯	tut
所	tutt
休	tuw
智	tvcd
侃	tveq
堡	tvfd
俣	tvgs
倔	tvjk
伲	tvjq
仲	tvjr
煲	tvoi
促	tvpw
保	tvuw
僻	tvvh
侣	tvvt
伏	tvw
倨	tvyt
仂	twe
俾	twhr
侧	twjr
傻	twnp
仉	twq
侨	twrr
伽	twvt
麂	twx
麝	txao
偃	txcl
俐	txjr
倭	txlt
鹿	txn
伛	txnw
麇	txo
何	txr
榘	txui
依	tyeb
麈	tyfs
住	tyft
侪	tynr
估	tyt
做	tytn
傍	tyuo
伉	tywq
僮	tzcf
侯	tzgs
每	tzi
俱	tzkw
伺	tzst
位	tzt
敏	tztn
倍	tzvt
殷	tzwm
毓	tzye
朽	uaa
栲	uaaa
颚	uabw
楮	uacg
槭	uaei
柘	uag
桡	uagr
鹗	uahh
栳	uaja
械	uamf
弟	uanw
导	uap
鄂	uarj
村	uas
梧	uavg
栅	ubbg
杯	ubgs
刺	ubjf
枘	ubls
楹	ubmw
枣	ubmy
极	ubos
枧	ubra
椰	ubrf
橱	ubsa
桐	ubsg
棘	ubub
橛	ubul
枥	ubwd
嚣	ubwu
概	ucfr
杳	ucg
查	ucgg
甑	ucgo
单	uchl
棍	ucjj
根	ucs
棵	ucus
楣	ucxg
榻	ucyy
皇	udd
梆	uder
桎	udfg
枉	udg
楔	udjs
椿	udlc
棒	udlj
楱	udls
榛	udlx
标	uds
白	udt
曾	uduc
柰	udy
橇	udzz
杉	ued
桴	ueeg
桩	uefg
李	ueg
帛	uek
榉	uekj
皤	ueqs
朔	ueqy
夔	uexp
首	uexs
栝	ueyg
杆	uff
桂	uffg
杜	ufg
棱	ufkp
姜	ufls
羡	ufml
羔	ufoo
羹	ufos
樾	ufpz
兰	ufs
美	ufso
枰	ufud
樯	ufuv
桔	ufvg
盖	ufws
羲	ufxa
恙	ufxo
槠	ugac
栈	ugad
槽	ugbc
柄	ugbl
桓	ugcg
梗	ugcn
本	uggn
椒	ugim
棹	uglf
桠	ugmg
材	ugnd
杖	ugns
杌	ugra
朴	ugs
栌	ugvd
桢	ugws
楠	uhbh
桕	uhg
判	uhju
半	uhln
校	uhns
皎	uhnw
郸	uhru
枝	uhs
叛	uhtm
冁	uhvb
翱	uhyy
植	uhzg
椟	uhzs
杷	uia
杪	uied
泉	uii
桫	uiie
档	uiig
棣	uiis
核	uils
兼	uioo
棂	uios
梢	uiqg
桃	uira
敝	uitn
皂	ujc
棋	ujdk
椹	ujdz
柚	ujg
枇	ujja
模	ujjs
楷	ujju
丫	ujl
檬	ujnb
栉	ujrf
榄	ujtr
槛	ujtw
槿	ujvd
桄	uka
柑	ukg
梭	ukkp
松	ukks
橙	uksu
益	ukws
桤	ukya
皑	ukyq
栓	uldg
桧	ulgd
检	ulge
榆	ulgj
枞	ulls
柃	ulps
枪	ulua
檎	ulyk
树	umas
普	umcs
棕	umds
柽	umfg
皖	umfr
杠	umg
楦	umgg
柠	umgn
瓶	umgo
柁	umja
横	umjk
檫	umkd
并	uml
桉	umlg
异	umm
权	ums
槟	umtk
棺	umxg
鹈	unhy
栊	unjd
剃	unju
枕	unra
杈	uns
榷	untl
攀	unun
樊	unus
术	uo
枋	uoa
尊	uoao
槁	uobv
榔	uocr
椁	uoeg
柙	uof
樗	uoga
榱	uogb
鹣	uohy
椋	uois
歉	uoql
酋	uos
檑	uosg
奠	uoso
敫	uotn
猷	uovo
杰	uoy
梃	upef
槌	upex
楗	upij
桶	upqj
槐	ups
懋	upux
格	upvg
魄	upw
杼	upzn
橘	upzv
檐	uqbg
桅	uqbu
柳	uqer
样	uqf
塑	uqfs
槲	uqjh
前	uqjl
剪	uqjm
煎	uqjo
翦	uqjy
构	uqks
楼	uqlg
槎	uqmg
榴	uqos
棚	uqqg
桷	uqqj
杓	uqs
槊	uquo
橡	uqvb
枸	uqvg
的	uqw
桁	urfn
栖	urg
椭	urhq
株	uris
枫	urns
柢	uros
梏	urvg
皓	urvt
榈	urvv
豢	usbb
拳	usdn
骂	usf
椤	usfs
杩	usg
柬	usgn
誊	usgs
皋	ushk
棰	usjf
榕	uslv
券	usmw
关	uso
楞	usoa
郑	usru
枨	uss
兽	usss
鼍	ussz
榨	ustf
桊	usuo
卷	usux
樘	usvf
鲞	usws
椅	usxf
眷	usxs
椴	utdm
柞	utfg
整	utgp
栀	utgu
杵	uthf
桦	utjh
椎	utlg
榫	utlh
樵	utlo
弊	utml
板	utms
皈	utmw
枚	utns
栎	uts
析	uttf
柝	utto
皙	utug
蹩	utvp
鳖	utws
憋	utxo
瞥	utxs
梅	utzs
梯	uuan
楂	uucg
禁	uudy
彬	uued
棉	uuef
栏	uufg
梦	uufy
柏	uug
棼	uukm
婪	uulg
巽	uumk
樽	uuoa
檄	uuon
焚	uuoy
郴	uurf
林	uus
楝	uusg
槔	uush
麓	uutb
森	uuuy
梵	uuwo
楚	uuzp
枵	uvaa
楫	uvbg
杏	uvg
束	uvgn
樨	uvij
榍	uviq
剌	uvjf
枳	uvks
赖	uvqw
兑	uvrx
敕	uvtn
哭	uvu
器	uvuf
榀	uvug
总	uvxo
椐	uvyg
机	uwa
橹	uwcg
桥	uwrf
蠲	uwsb
咒	uwv
枷	uwvg
樱	uwwl
馘	uxag
榭	uxas
框	uxdg
柯	uxf
相	uxg
榧	uxid
枢	uxns
楸	uxos
柩	uxqo
栋	uxs
柜	uxug
想	uxxy
杞	uya
柿	uyef
柱	uyfg
枯	uyg
梳	uyke
木	uyn
榜	uyuo
杭	uywa
檩	uyxd
檀	uyxg
栩	uyyg
札	uza
橄	uzbn
椽	uzeb
梓	uzhf
樟	uzlf
巳	uzn
鹚	uzoh
兹	uzoo
杨	uzrd
榇	uzus
已	uzz
橼	uzzb
孳	uzze
慈	uzzx
屠	vaca
嘟	vacr
哮	vaeh
嘁	vaei
喊	vaes
哓	vagr
嗜	vajc
吲	vajj
嘛	val
熨	vaop
号	vav
唔	vavh
慰	vaxp
戢	vbar
喱	vbcf
啁	vbfv
呸	vbgg
呐	vbll
呙	vblu
嗫	vbmm
吸	vbol
虽	vbu
噘	vbul
呃	vbum
啄	vbvb
呖	vbwk
嘎	vbxa
嗄	vbxp
喁	vcbk
嘬	vcbm
唱	vcch
哩	vcfh
呻	vcjj
吻	vck
哏	vcl
喝	vcqz
唧	vcrj
唿	vcxl
黾	vczv
尉	vdax
呈	vdf
屋	vdfa
呱	vdl
唪	vdlj
嗪	vdlx
唛	vdpl
嗷	vdqn
郢	vdrj
啧	vdwl
嗉	vdzi
尾	vdzz
噢	vebs
响	vebv
孱	veee
吊	vej
吒	vejm
刷	vejv
嗳	venm
嚼	vesa
呼	veun
属	vevk
咱	vexh
嗅	vexv
吼	vezm
哇	vffh
哆	vffl
吐	vfh
味	vfil
嗑	vfkw
呋	vfll
吁	vfnj
呀	vfnk
噎	vfnu
哧	vfol
口	vft
嘭	vfue
咭	vfvh
嘻	vfvv
呒	vfzm
嘈	vgbc
哽	vgcn
层	vgdp
咔	vggg
吓	vggl
唁	vgh
咧	vgjj
卟	vgl
哑	vgmh
叮	vgnj
吴	vgsu
喃	vhbh
呜	vhgh
鸣	vhh
叶	vhj
嗖	vhjm
喷	vhjw
吱	vhl
嘲	vhlq
噬	vhml
嗦	vhni
咬	vhnl
嚏	vhnp
咴	vhol
嗔	vhzk
啡	vidh
吵	viek
啸	viir
咳	vill
吧	vim
尿	vip
屑	viqa
哨	viqh
啵	viqm
犀	virj
嗨	vitz
邑	viv
唢	viwl
届	vja
噶	vjcz
呓	vjfm
嗤	vjhb
喏	vjhv
嘞	vjhw
哔	vjjh
吡	vjjm
中	vjjn
喈	vjju
屁	vjjz
咄	vjkj
屈	vjkm
嘶	vjkt
嗒	vjls
叱	vjm
哎	vjnl
唠	vjnw
嚆	vjov
喵	vjsh
嗬	vjtx
盅	vjwf
忠	vjxu
尼	vjz
喋	vjzu
屉	vjzz
喘	vkbj
哕	vkfl
唆	vkkp
嗡	vkky
叭	vkl
咣	vkm
吩	vkmk
嗲	vknf
嘣	vkqq
哞	vkrj
吮	vkrm
噔	vksu
唉	vkts
只	vku
殿	vkwm
啭	vlfo
啥	vlfv
哙	vlgd
喻	vlgj
剐	vljj
噻	vlkf
唑	vllf
呶	vlml
呤	vlpl
哈	vlsh
呛	vlum
噙	vlyk
尻	vlz
吟	vlzm
展	vmbp
咤	vmej
哪	vmfr
喧	vmgg
咛	vmgn
叨	vmk
嚓	vmkd
哄	vmkl
叹	vml
啜	vmmm
嗓	vmmu
啶	vmpl
喀	vmpv
噗	vmqo
嘧	vmxk
哝	vneb
咀	vnh
唏	vnhe
叫	vnj
咙	vnjk
哺	vnqh
哳	vntt
啪	vnuh
史	vnun
啦	vnzh
嚅	vobj
昼	vocg
啷	vocr
呷	voj
尽	vomp
嚎	vonb
哼	vonj
啖	vool
尺	vop
嚯	votl
嗾	vots
咫	vovk
唳	vovv
咏	vozi
嘴	vpjj
呲	vpjm
啮	vplj
咚	vpml
嗵	vppj
啃	vpqh
哒	vpsl
足	vpu
咯	vpvh
唤	vqbs
鹃	vqhh
咩	vqj
哦	vqk
咪	vql
屡	vqla
喽	vqlh
吹	vqll
嗟	vqmh
尸	vqn
屎	vqp
羼	vqqq
啕	vqrk
咆	vqum
噱	vrbb
嘌	vrdl
哂	vrh
屐	vrhp
叩	vrj
饕	vrlc
嘘	vrmh
屣	vrpp
屦	vrql
履	vrtp
兄	vrv
唬	vrwm
啊	vrxj
屙	vrxm
咦	vsam
嗝	vsbj
喹	vsff
嘿	vsfo
喂	vsgb
吗	vsh
囔	vsjb
唾	vsjj
呔	vsol
喟	vsqh
嘹	vsui
咐	vtal
咋	vtfh
吃	vtfm
咿	vtie
哗	vtjh
唯	vtlh
噍	vtlo
哌	vtqb
听	vttj
咻	vtul
喉	vtzs
喳	vucg
噌	vudc
嗍	vueq
品	vuf
吖	vujj
唣	vujm
嗌	vukw
屏	vumm
嗥	vush
呆	vuu
噤	vuud
啉	vuul
喇	vuvj
嗽	vuvl
喔	vvdf
唰	vvej
嘱	vvek
吕	vvf
串	vvjj
呢	vvjm
患	vvjx
吠	vvl
鄙	vvrj
噪	vvuu
噼	vvvh
飙	vvvn
辟	vvzh
噜	vwch
啤	vwhj
别	vwjj
叻	vwk
呗	vwl
叽	vwm
臀	vwqa
另	vwr
郧	vwrj
员	vwu
哚	vwul
咖	vwvh
勋	vwwk
嘤	vwwl
嗣	vwzs
哐	vxdh
咂	vxej
呵	vxj
吣	vxl
呕	vxnl
啾	vxol
咽	vxsl
嗯	vxsx
居	vya
咕	vyh
剧	vyjv
唷	vykq
啐	vylh
犬	vyn
哜	vynr
嚷	vyub
啼	vyue
嘀	vyuy
吭	vywm
吨	vyzm
喑	vzch
噫	vzcx
擘	vzdn
璧	vzdo
喙	vzeb
壁	vzfa
譬	vzga
叼	vzgh
甓	vzgo
嬖	vzla
唼	vzlh
鐾	vzlu
劈	vzmq
吆	vzol
呦	vzow
臂	vzqa
哟	vzql
檗	vzup
局	vzva
襞	vzyb
咝	vzzg
赌	wach
贼	wahk
鳍	wajc
痦	wavs
鲕	wbbj
赈	wbfb
鲷	wbfv
痞	wbgv
鳢	wbmu
鲰	wbmw
鳜	wbul
瘃	wbvb
疬	wbww
鲥	wcaw
赐	wcck
鲳	wcct
鲁	wcd
鲤	wcft
疸	wcgs
鲲	wcjj
几	wcn
痕	wco
鲫	wcrr
鳗	wcsm
鲻	wcst
瘟	wcws
鳎	wcyy
瘛	wdjx
鱼	wdn
鲭	wdqt
瘢	wdwm
癍	wdyd
赃	wefh
存	weg
鳙	weij
贬	wepl
鳐	werk
瘪	wexj
鲧	wezi
痔	wfao
鲑	wfft
在	wfg
鲮	wfkp
皿	wfn
鲆	wfue
鲒	wfvt
痣	wfxo
贱	wgak
赋	wgap
病	wgbl
鲡	wgbo
鲠	wgcn
痖	wgms
财	wgnk
疔	wgnl
症	wgps
疠	wgqx
鲈	wgve
贴	wgvh
鲇	wgvt
鹎	whht
瘦	whjm
鲼	whjw
卑	whk
瘐	whlo
鲛	whnw
贿	whqh
鲔	whqt
鲵	whrq
郫	whrr
赎	whzs
癫	whzw
鲟	wiaw
痱	wids
鲱	widt
痧	wiie
赅	will
瘠	wilq
夭	win
疤	wix
鳓	wjhw
则	wjj
瘼	wjjo
瘩	wjls
鲣	wjmf
痨	wjnw
鲽	wjzu
瘵	wkdo
岙	wkk
疝	wkl
办	wkp
疳	wks
贻	wkvh
鲐	wkvt
赊	wldl
痊	wlds
疹	wlew
痤	wllf
疥	wlrl
疮	wlux
鲶	wlzx
鲩	wmfr
贮	wmgh
殳	wmi
癀	wmjk
瘫	wmtl
瘙	wnbo
鳋	wnbw
囟	wni
赇	wnil
疗	wnl
痉	wnms
鲅	wnmw
赙	wnqa
疽	wns
鱿	wnzq
疣	wnzx
凡	woi
鳕	woit
鲸	woiw
瘀	wolm
赕	wool
痰	wooo
鲂	woq
鳊	wovw
囱	wpi
疵	wpjx
鲢	wplr
疼	wpmo
痛	wpqj
鲦	wpuw
赂	wpvh
粤	wqac
赡	wqbg
痪	wqbs
鳞	wqfj
痈	wqjl
购	wqkl
痒	wql
瘘	wqls
疲	wqmo
瘥	wqms
疚	wqoo
瘤	wqos
鲜	wqr
力	wqt
鲍	wquq
鳝	wquv
疱	wqux
瘭	wrdo
鳔	wrdw
乔	wrk
疖	wrl
疯	wrno
癃	wrpd
瘾	wrqx
痫	wruo
痍	wsax
痹	wsgr
鳏	wsiw
账	wsl
疒	wsnp
瘗	wsuf
痘	wsus
鳃	wsxw
瘰	wszi
鲋	wtaw
鳆	wtcp
痄	wtfs
疙	wtfx
贩	wtml
败	wtnl
疾	wtso
痴	wtsv
瘊	wtzs
瘅	wuch
赠	wudc
鳇	wudt
瘕	wufm
鳄	wuga
朵	wui
赚	wuio
剁	wujr
贝	wun
鳟	wuoa
瘌	wuvj
癞	wuvw
加	wvb
癜	wvmm
赆	wvom
贶	wvrm
驾	wvsa
癌	wvuk
架	wvup
癖	wvvh
贺	wvwp
哿	wvxm
袈	wvyb
婴	wwlf
鹦	wwlh
疫	wwmo
癣	wwql
罂	wwrk
瘸	wwvl
痂	wwvs
瘿	wwwl
勰	wwwx
疟	wxgs
痢	wxjl
疴	wxl
痿	wxls
鳅	wxow
稣	wxw
癯	wxxl
痼	wxys
鲴	wxyt
疰	wyfs
瘁	wylh
鲚	wynr
瘳	wyye
痃	wyzo
癔	wzcx
鲺	wzeb
瘴	wzll
疡	wzrw
赔	wzvh
睹	xach
躬	xaq
圄	xavf
射	xaw
秀	xbc
睚	xbff
稠	xbfv
匚	xbnp
秧	xbsw
匮	xbwy
香	xcd
眼	xcl
囫	xcr
馥	xctp
稞	xcuw
匡	xdg
围	xdj
国	xdou
圊	xdqf
睛	xdqh
季	xed
稃	xeet
囝	xef
匝	xeh
稻	xeht
瞬	xenj
眨	xepl
身	xet
睬	xeul
必	xewn
秭	xezn
眭	xffh
眵	xffl
移	xffw
睦	xfkf
瞌	xfkw
目	xfn
盱	xfnj
囗	xfnp
秆	xfr
园	xfrv
秤	xfue
圉	xfuh
穑	xfuv
秸	xfvt
穗	xgcx
睫	xgip
盯	xgnj
团	xgnr
睐	xgql
秣	xguw
鸫	xhg
瞍	xhjm
可	xhn
囿	xhqf
睨	xhrm
稹	xhzk
躺	xibv
匪	xidg
秉	xidn
秒	xiee
眇	xiek
黏	xigv
禾	xin
稍	xiqt
眺	xirm
颐	xjbw
赜	xjdw
瞒	xjgl
卧	xjgs
匿	xjhv
慝	xjhx
秕	xjjq
剩	xjjr
利	xjr
犁	xjrj
瞄	xjsh
梨	xjui
臣	xjuj
秽	xkfw
睽	xkgs
睃	xkkp
盼	xkmk
眸	xkrj
瞪	xksu
眙	xkvh
私	xkw
委	xld
囡	xlf
睑	xlge
黍	xlii
囵	xljv
匦	xllb
囹	xlpu
魏	xlpw
郾	xlrf
囚	xlu
稔	xlzx
稼	xmbb
瞎	xmfy
科	xmhr
瞑	xnch
瓯	xngo
稀	xnhe
鸥	xnhg
乘	xnjc
圃	xnqf
欧	xnql
眈	xnrm
租	xnt
殴	xnwm
区	xny
稽	xnzc
嵇	xnzk
稿	xobv
稂	xocw
匣	xoh
心	xon
匾	xovw
秋	xow
愁	xoxi
眦	xpjm
眠	xpm
图	xpmu
瞻	xqbg
蠃	xqbo
瞵	xqfj
睁	xqin
称	xqiw
稳	xqix
眯	xql
黎	xqli
嬴	xqlo
羸	xqqo
黧	xqso
赢	xqwo
匹	xrb
瞟	xrdl
秩	xrlw
睡	xsjj
稷	xskp
圜	xssb
因	xsu
瞠	xsvf
恩	xsxu
睢	xtlh
瞧	xtlo
稚	xtlt
医	xtsy
匠	xtth
眄	xtzz
睇	xuan
巨	xug
穆	xuie
秫	xuow
熙	xuoy
圈	xusu
困	xuu
税	xuvr
程	xvdt
瞩	xvek
回	xvf
叵	xvg
种	xvjr
积	xvkw
和	xvt
稆	xvvt
圆	xvwu
颓	xwbw
秃	xwc
睥	xwhj
稗	xwhr
躲	xwuw
翳	xwyy
眶	xxdh
秘	xxee
哥	xxh
氍	xxlz
眍	xxnl
躯	xxnw
瞅	xxol
歌	xxql
瞿	xxtl
矍	xxtm
固	xyf
东	xyn
穰	xyub
盹	xyzm
眩	xyzo
囤	xyzv
瞰	xzbn
鼎	xzbz
瞳	xzcf
铐	yaaq
锗	yact
铙	yagr
铑	yajq
习	yan
铖	yaqq
镄	yarw
镪	yavb
铽	yaxw
钺	yazq
瓤	ybdo
钚	ybgw
钠	yblw
镊	ybmm
钢	ybnw
铜	ybst
铒	ybt
镢	ybul
锡	ycce
锂	ycft
锝	ycga
钽	ycgt
锟	ycjj
钅	ycnp
镘	ycsm
锱	ycst
裹	ycub
锞	ycuw
银	ycw
镅	ycxt
锪	ycxw
铸	ydea
锲	ydjs
钰	ydow
锖	ydqt
锊	yeaw
衣	yebo
裔	yebv
钐	yee
铥	yefk
锾	yefm
锸	yehh
钎	yehr
镛	yeij
镀	yejm
市	yel
镰	yeuo
锰	yewt
镍	yexu
铘	yfnr
钇	yfq
主	yfs
钍	yft
铭	yfvt
钱	ygae
颤	ygbw
芈	ygfj
钙	yggz
钉	ygnr
卞	ygo
钲	ygpt
铼	ygqw
古	ygt
钻	ygvt
钋	ygw
裒	yheb
钸	yher
鸪	yhg
钨	yhgt
锼	yhjm
铰	yhnw
铕	yhqt
针	yhr
镇	yhzk
钞	yiee
铛	yiit
锓	yinm
钯	yiq
销	yiqt
铫	yirq
锁	yiww
率	yizh
铴	yizr
锘	yjhv
锴	yjju
镆	yjjw
铿	yjmf
铹	yjnw
钊	yjr
锚	yjst
铀	yjt
镬	yjtm
弃	ykml
育	ykqs
充	ykrx
镫	yksu
钳	ykt
铠	ykyq
铨	yldt
锉	yllf
卒	yllh
铃	ylpw
镎	ylsn
铪	ylst
钕	ylt
铷	ylvt
钤	ylzq
镓	ymbb
错	ymct
铎	ymfj
钭	ymhr
铊	ymjq
镲	ymkd
铵	ymlt
锭	ympw
镤	ymqo
镔	ymtk
斋	ynbj
锵	ynfa
斌	yngp
离	ynjk
刘	ynju
亵	ynlb
钹	ynmw
文	yno
铺	ynqt
钌	ynr
齑	ynrg
齐	ynrl
斓	ynrs
铩	ynuw
吝	ynvs
钗	ynw
锄	ynwe
紊	ynzi
弯	yoax
脔	yobl
蛮	yobo
镐	yobv
锒	yocw
挛	yodn
锿	yoeb
镦	yoen
孪	yoes
鸾	yohs
峦	yokl
娈	yols
銮	yolu
弈	yoml
变	yomo
亦	yoo
锬	yoow
钫	yoq
钾	yor
奕	yoso
镭	yost
镟	yotp
镞	yots
栾	youo
钬	yow
恋	yoxo
锋	ypdj
铤	ypef
键	ypij
链	yplr
铬	ypvt
袤	ypzb
望	yqds
锇	yqe
铆	yqer
胡	yqg
鹕	yqhg
铮	yqin
铯	yqiq
钩	yqkw
镂	yqlt
钦	yqlw
钧	yqmt
铍	yqmw
镏	yqos
钥	yqt
钓	yqw
克	yrb
锏	yrct
镖	yrdw
锎	yrgm
铢	yriw
钏	yrjr
剂	yrju
镡	yrlr
铁	yrlw
钔	yrq
铣	yrrq
镧	yrus
锆	yrvt
锕	yrxr
兢	yryr
镉	ysbj
锺	ysct
锣	ysfw
锛	yshm
锤	ysjr
亠	ysnp
钛	ysow
镯	ysqb
亩	yss
钿	yst
镣	ysui
铗	ysut
镗	ysvf
镩	ysvj
锶	ysxw
镙	yszi
锻	ytdm
铧	ytjh
镌	ytlb
锥	ytlt
钣	ytmw
故	ytns
改	ytnx
镳	ytow
夜	ytpo
锨	yttl
褒	ytvb
铄	ytw
锑	yuan
商	yubv
锦	yuer
嘏	yufm
镁	yufs
锷	yuga
襄	yugb
钵	yugt
镒	yukw
镨	yumc
帝	yune
旁	yuno
啻	yunv
锩	yusu
铂	yut
锐	yuvr
锅	yvbl
锃	yvdt
铞	yver
铌	yvjq
钟	yvjr
铝	yvvt
锯	yvyt
锔	yvzv
颃	ywbw
镥	ywct
铡	ywjr
钒	ywow
铅	ywvt
钡	yww
亢	ywx
锈	yxbq
铋	yxee
锹	yxow
忌	yxp
钶	yxr
铟	yxsw
钼	yxt
钜	yxut
禀	yxvd
钷	yxvt
锢	yxyt
羽	yyb
戮	yyea
铱	yyeb
鹨	yyeh
铈	yyer
锍	yyke
铳	yykr
戳	yyla
羿	yymm
翼	yysk
钴	yyt
翟	yytl
镶	yyub
镑	yyuo
镝	yyuy
钪	yywq
翠	yyyh
翌	yyza
铉	yyzo
钝	yyzq
屯	yzbn
顿	yzbw
镜	yzcr
镱	yzcx
铲	yzee
雍	yzel
钮	yzft
辜	yzhh
锌	yzhr
饔	yzlc
壅	yzlf
妄	yzls
己	yzn
玄	yzoo
畜	yzos
氓	yzpp
钆	yzq
肓	yzqs
邙	yzru
锫	yzvt
亡	yzx
忘	yzxo
盲	yzxs
绪	zacb
缄	zaes
绕	zagr
绒	zahc
纟	zanp
绋	zarv
纣	zax
缛	zbfa
绸	zbfv
纳	zblx
纲	zbnx
级	zbox
飞	zbp
敢	zbtn
毅	zbwm
缋	zbwx
缅	zbxf
缫	zccu
童	zcfs
绲	zcjj
绅	zcjv
韶	zcmv
缇	zcpx
歆	zcql
韵	zcqm
竭	zcqz
竟	zcrx
音	zcs
缁	zcsb
缦	zcsm
意	zcxo
绑	zder
靖	zdqy
纬	zdv
绩	zdwx
蠡	zebb
虱	zebp
颜	zebw
纩	zec
缠	zecf
彦	zeew
缓	zefm
纤	zehv
绥	zelb
飨	zelc
绶	zenm
乡	zeq
彖	zevb
产	zew
丑	zfa
录	zfip
绫	zfkp
纡	zfnv
结	zfvb
缬	zfvw
刁	zga
线	zgac
绠	zgcn
纭	zgdx
绰	zglv
缙	zgmc
缰	zgsg
站	zgvy
瓣	zhdh
辩	zhgh
辛	zhl
绞	zhnx
辨	zhoh
毋	zhqn
辣	zhuv
贯	zhwp
辫	zhzh
缜	zhzk
续	zhzs
绱	zibv
绯	zidb
纱	ziec
剥	zijv
绡	ziqb
纰	zjjz
绌	zjkv
彘	zjtj
缆	zjtr
缂	zjvh
绁	zjzz
绀	zkb
端	zkbj
竣	zkkp
纷	zkmc
具	zku
绐	zkvb
彰	zlei
绘	zlgd
纶	zljz
章	zll
纵	zllx
纨	zlox
赣	zlpw
鄣	zlru
妾	zls
给	zlsb
辔	zlzv
红	zmb
综	zmdx
绎	zmfj
缀	zmmm
纫	zmox
绽	zmpx
买	zmsp
缩	zmtc
缤	zmtk
绍	zmvb
绾	zmxb
组	znb
经	znmb
绂	znmx
缚	znqa
纠	znv
缟	zobv
糸	zoip
幺	zop
编	zovw
幼	zowc
纺	zoz
幽	zozk
畿	zozs
幻	zozz
蛋	zpbp
缱	zpbx
缗	zpcb
缒	zpex
绛	zpfj
绺	zpgv
终	zpmx
母	zpn
发	zpop
疋	zpp
缝	zppj
胥	zpqa
绦	zpux
络	zpvb
戆	zpxo
疏	zpye
纾	zpzn
绚	zqcb
绉	zqib
绝	zqiz
缕	zqlb
绷	zqqb
缮	zquv
约	zqx
彝	zqzm
继	zqzz
缥	zrdx
绗	zrfn
飒	zrno
缵	zrrw
纸	zrz
司	zsa
细	zsb
绔	zsga
缍	zsjv
缳	zssb
立	zst
缭	zsui
绮	zsxv
缌	zsxx
缧	zszi
缎	ztdm
纥	ztfz
缏	ztgn
维	ztlb
憨	ztxp
缑	ztzs
绨	zuan
缯	zudc
绵	zuev
绊	zuhv
缣	zuio
缢	zukw
亲	zuo
缴	zuon
绻	zusu
新	zutt
竦	zuvy
缃	zuxb
缉	zvbb
绳	zvcz
瓿	zvgo
剖	zvju
织	zvkx
绢	zvqb
部	zvru
竞	zvrx
缲	zvuu
缨	zwwl
绣	zxbz
缈	zxie
练	zxx
统	zykr
缡	zynk
纹	zynx
缔	zyue
缪	zyye
翊	zyyy
纪	zyz
纯	zyzz
缘	zzeb
纽	zzfb
绿	zzfi
丝	zzga
鸶	zzgh
书	zzjo
乜	zzzn