到	a
臦	aa
燛	aaow
匦	aaqt
匭	aaqt
臩	aasr
叵	ab
區	abbb
匰	abbf
毆	abbm
剾	abbn
歐	abbq
鷗	abbq
敺	abbv
甌	abby
尀	abgy
匮	ablm
匱	ablm
贒	ablm
䢻	ac
匜	acl
匠	aek
㔸	aelm
车	af
輚	afaa
轟	afaa
輱	afab
䡱	afab
䡛	afaf
軭	afah
轼	afaj
轾	afaj
軾	afaj
輊	afaj
轞	afam
轗	afap
軎	afb
䡲	afbf
辑	afbh
輯	afbh
毄	afbm
轀	afbm
軦	afbq
轵	afbw
軹	afbw
轺	afcb
軺	afcb
轇	afce
軐	afcf
䡃	afct
轫	afcy
軔	afcy
䡼	afdb
轉	afdg
輏	afdk
轜	afds
辅	afdu
輔	afdu
轌	afdv
䡿	afdw
椠	afed
槧	afed
堑	afej
塹	afej
䟅	afej
斩	afek
斬	afek
蹔	afel
䡮	afel
輴	afem
㟻	afem
暂	afen
暫	afen
慙	afep
覱	afeq
䳻	afeq
磛	afes
㨻	afet
輈	afeu
辀	afeu
䡊	afev
錾	afew
鏨	afew
䭕	afew
軱	afex
㜞	afex
轱	affb
軲	affb
䡳	affe
轩	affl
軒	affl
轒	affm
䡷	affm
轥	affr
䡹	affv
䡋	affv
輁	affw
轕	affw
䡩	affw
䡸	affx
軖	afh
䡺	afhp
輤	afhq
辏	afhs
輳	afhs
轃	afht
輙	afhv
轊	afhv
辄	afhx
輒	afhx
車	afii
輎	afiq
輄	afis
𨐈	afis
轖	afjb
䡜	afjj
辕	afjq
轅	afjq
䡇	afjq
輘	afjt
转	afjv
䡍	afjw
転	afjx
轲	afkb
軻	afkb
輕	afkj
䡖	afkj
輌	afkm
辐	afkn
輻	afkn
軯	afku
辆	afkw
鑋	afkw
軘	afkx
輛	afky
轤	aflm
䡠	aflm
䡾	afls
轳	aflv
軙	aflv
輖	afmb
䡄	afmg
轘	afmq
軮	afms
輲	afms
撃	afmt
軗	afmv
軜	afmw
繋	afmx
軕	afmx
辋	afmy
軓	afmy
輞	afmy
䡒	afnb
輠	afnd
輰	afne
輫	afnf
轛	afng
輼	afnm
辒	afnm
轠	afnn
轴	afno
軸	afno
轐	afnu
䡬	afnv
輵	afnw
辊	afnx
輥	afnx
軣	afo
轋	afpa
䡣	afpa
辖	afpb
轄	afpb
䡥	afpb
軶	afpc
䡪	afpc
䡝	afpc
䡢	afpf
䡫	afph
輐	afpq
䡵	afps
𫟦	afps
輨	afpv
䡎	afpv
䡐	afpx
䢁	afq
軝	afqa
𬨂	afqa
軥	afqb
轹	afqi
䡘	afqn
䡧	afqo
輓	afqq
輣	afqq
䡔	afqq
輡	afqr
轨	afqt
軌	afqt
軳	afqv
软	afqw
軟	afqw
鿂	afqx
軧	afqy
輷	afqy
䡅	afr
䡟	afrf
軵	afrg
䡯	afrp
輗	afrq
䡚	afrq
𫐐	afrq
匶	afrr
䡻	afry
匿	afsb
輢	afsb
轭	afsc
軛	afsc
轑	afsi
轣	afsl
䘌	afsl
輀	afsm
慝	afsp
輭	afss
軏	afsx
䡌	afsx
𫐄	afsx
軑	afsy
軚	afsy
軷	afsy
轪	afsy
軞	afta
辂	aftb
輅	aftb
轎	aftb
䢀	aftc
輧	aftf
軠	aftj
䡽	aftm
轿	aftr
輹	aftt
轷	aftu
軤	aftu
轶	aftw
軼	aftw
轙	afua
輶	afud
𬨎	afud
軿	afuf
辚	afut
轔	afut
䡭	afuv
䡑	afva
輑	afvb
轏	afvc
輮	afvd
䡦	afvd
𫐓	afvd
轻	afvj
軽	afvj
䡕	afvk
辗	afvq
輾	afvq
轰	afvv
辍	afvv
輟	afvv
䡏	afvx
䡶	afvy
輍	afwb
轸	afwe
軫	afwe
輪	afwf
龫	afwf
辁	afwh
輇	afwh
输	afwn
輸	afwn
轓	afwn
軨	afwp
轁	afwr
㲦	afwt
軡	afwv
䮧	afwv
䡈	afww
轮	afwx
䡆	afwx
轧	afx
軋	afx
轚	afxa
軩	afxb
軪	afxc
檕	afxd
轈	afxd
轢	afxd
墼	afxj
蟿	afxl
䡂	afxl
辎	afxn
輜	afxn
輺	afxn
輽	afxn
䡡	afxr
礊	afxs
擊	afxt
罊	afxt
繫	afxx
軴	afyh
輬	afyi
辌	afyi
䡴	afyj
䡉	afym
辙	afyt
轍	afyt
䢂	afyu
䡙	afyv
较	afyw
較	afyw
輆	afyw
辘	afyx
轆	afyx
七	ag
㐂	agaa
切	agco
袃	agcq
鸫	agiq
东	agiw
匡	ah
邼	ahc
劻	ahct
赜	ahmw
賾	ahmw
匤	ahy
臣	ai
匚	aiii
匸	aiii
匯	airl
至	aj
臹	ajac
臸	ajaj
㬜	ajan
郅	ajc
䑒	ajcy
臻	ajht
匞	ajl
匵	ajmm
到	ajng
鵄	ajqx
䶍	ajrr
臶	ajsc
臵	ajtb
致	ajtw
㔷	akmw
㼢	akxy
牙	al
邪	alc
䖙	alem
卧	alg
鸦	alqx
鴉	alqx
雅	alrl
䪵	alsw
㸧	alvq
𬌗	alwb
䭆	alwv
㸦	aly
㔯	amb
䝂	amku
匝	aml
匷	ammr
匪	anf
㔴	anfw
匣	anp
䑑	anuh
郾	anxc
匽	anxk
鶠	anxq
㰽	anxq
𬸘	anxq
䑞	aoot
匾	apmf
䣟	aqac
蠶	aqal
朁	aqan
㔆	aqan
兓	aqaq
䫬	aqas
鬵	aqau
匢	aqe
匫	aqen
匹	aqg
兂	aqg
旡	aqg
朢	aqh
㔰	aqlg
炁	aqow
㤅	aqpu
鴄	aqqx
匛	aqy
龨	arl
㔱	arwg
匲	asbb
颐	asw
頣	asw
頤	asw
㥦	aswp
㰼	aswq
匧	asww
戈	at
㦶	ataj
盞	atam
虦	atam
剗	atan
戔	atat
戓	atb
臨	atbb
戜	atbh
㳼	atbi
或	atbk
盬	atbm
惑	atbp
㰲	atbq
䰥	atbr
成	atc
郕	atcc
盛	atcm
䫆	atcs
㼩	atcy
戒	atf
戊	atii
戋	atii
㦮	atii
䑐	atiw
戌	atk
咸	atkb
䶠	atkl
烕	atko
感	atkp
觱	atkq
㰹	atkq
顑	atks
䫲	atks
威	atkx
䌠	atkx
㗤	atlb
戚	atli
蹙	atll
鹽	atlm
慼	atlp
顣	atls
㞝	atlv
㗨	atmb
翳	atmc
醫	atmd
匴	atmf
㙠	atmj
䗟	atml
瞖	atmm
贀	atmm
黳	atmm
盏	atmn
鷖	atmq
鹥	atmq
㬾	atmq
䃜	atms
殹	atmv
毉	atmw
嫛	atmx
繄	atmx
瑿	atmy
划	atng
刬	atng
悘	atpu
医	ats
戎	ats
翘	atsc
尧	atsx
㦴	attb
㥻	attp
戉	atx
臧	atxa
㦯	atxk
戍	aty
㯺	atyd
監	atym
㔋	atyn
覧	atyq
覽	atyq
擥	atyt
㲯	atyt
䜿	atyu
鍳	atyw
鑒	atyw
譼	atyy
㽉	atyy
巨	av
䢹	avc
乬	avcg
孯	avck
堅	avj
豎	avku
蜸	avl
螶	avll
䁂	avm
賢	avmw
熙	avow
煕	avow
㷂	avow
巸	avp
腎	avq
硻	avs
掔	avtg
㹂	avtl
䵖	avtw
巪	avv
㔵	avvw
鋻	avw
緊	avx
婜	avxk
媐	avxk
臤	avy
竪	avyu
匼	awb
匳	awbw
臥	awg
瓯	awky
㔳	awmg
殴	awmv
匬	awqn
㔲	awqt
欧	awqw
鸥	awqx
鴎	awqx
区	awy
匥	axf
匩	axh
匨	axsj
弋	ay
䛗	ay
彧	ayek
甙	ayfj
㔶	ayfm
弎	ayhg
弍	ayjg
式	ayjl
贰	ayjm
貳	ayjm
弌	ayk
匟	aymg
貣	aymw
忒	aypu
鸢	ayqx
鳶	ayqx
隿	ayrl
㻨	ayvy
䬥	aywv
中	b
嘔	babb
㖪	babk
囀	badg
唓	baf
㖑	baf
哐	bah
咥	baj
啭	bajv
㖅	bak
喊	bakb
喴	bakx
呀	bal
嘁	bali
咂	baml
噆	baqn
哓	basx
嚂	batm
囕	batq
㘋	bavm
呕	bawy
吕	bb
吅	bb
嚚	bbab
嘓	bbak
品	bbb
㗊	bbbb
鄵	bbbc
噪	bbbd
喿	bbbd
嘽	bbbf
喦	bbbm
嵒	bbbm
劋	bbbn
碞	bbbs
氉	bbbt
㘙	bbbt
㗁	bbbx
郘	bbc
哵	bbcn
咽	bbg
啯	bbhy
喌	bbir
噐	bbjb
鄂	bbjc
卾	bbjc
㓵	bbjn
鹗	bbjq
覨	bbjq
鶚	bbjq
颚	bbjs
顎	bbjs
咢	bbjx
呺	bbkx
㕺	bbkx
串	bbl
哫	bbll
嘳	bblm
患	bblp
咒	bbmg
㖞	bbmw
戰	bbna
嘼	bbnb
㽞	bbnb
鄲	bbnc
單	bbnf
鼉	bbnp
囅	bbnq
鷤	bbnq
獸	bbns
辴	bbns
鼍	bbnx
斝	bbpf
䑝	bbpt
嗯	bbpu
呪	bbqg
丳	bbr
器	bbsb
嚣	bbsb
嚻	bbsb
囂	bbsb
嚴	bbst
哭	bbsu
㖥	bbtd
䣞	bbuc
㖾	bbux
骂	bbv
駡	bbv
唈	bbvn
㖐	bbvt
呮	bbw
嘂	bbxb
叩	bc
咖	bcb
呞	bcb
㗎	bcbd
嗋	bccq
哪	bcjc
叼	bck
吇	bck
啊	bckb
吔	bcl
唨	bcmh
别	bcng
別	bcng
叨	bco
叧	bco
㗗	bcrf
嚁	bcrl
㗩	bcrn
另	bct
叻	bct
唌	bctl
嘐	bcwe
䬭	bcwv
吼	bcx
吸	bcy
噿	bcyf
呆	bd
㕲	bd
槑	bdbd
啉	bdd
㗚	bdd
噤	bddj
唽	bdek
喖	bdfb
哂	bdg
㗘	bdgy
㖶	bdj
嘌	bdji
呠	bdk
唒	bdk
㘄	bdmy
嘾	bdnf
喳	bdnk
嚯	bdrl
嚅	bdsm
哺	bdu
嘜	bdwt
唻	bdww
喓	bdxk
㘊	bdy
哘	beg
听	bek
㖃	bekb
嘥	bell
嗁	belm
嘚	beng
唙	beow
哌	beq
㗸	betm
㘅	bew
㗰	bewl
呱	bex
㘕	bfam
咕	bfb
啚	bfbb
鄙	bfbc
嚾	bfbr
嘆	bfbw
呓	bfcg
嘞	bfct
㖼	bfd
嘶	bfek
㗆	bff
喷	bffm
噴	bffm
叶	bfg
唭	bfh
咁	bfj
嚡	bfjj
囈	bfjx
嘩	bfkj
㗕	bfmj
嗔	bfmw
唶	bfn
喵	bfnb
囆	bfnl
嘲	bfnq
嗼	bfns
噶	bfnw
噧	bfny
唠	bfpc
哱	bfpc
嚔	bfpl
嚏	bfpv
嗦	bfpx
㗅	bfq
㖴	bfqe
㗣	bfqm
囌	bfqt
嗬	bfrb
嚿	bfrr
嚄	bfrv
㗾	bfrx
喏	bfsb
㘃	bfsp
喃	bfu
囒	bfui
嚥	bfuo
吱	bfvy
哄	bfw
嗒	bfwb
嗏	bfwt
哎	bfwy
呭	bfx
啿	bfx
喋	bfxd
嚆	bfyb
因	bg
爴	bgae
國	bgak
回	bgb
圖	bgbb
圆	bgbm
圓	bgbm
圚	bgbm
㘣	bgbq
囝	bgck
㘞	bgct
困	bgd
圑	bgdg
團	bgdg
圃	bgdu
哳	bgek
㘟	bgf
固	bgfb
团	bggt
団	bggy
囯	bgh
圊	bghq
国	bghy
囗	bgii
囦	bgio
㘤	bgir
㘢	bgis
围	bgjc
圔	bgjm
园	bgjq
園	bgjq
囲	bgjr
圉	bgju
囩	bgjx
圄	bgkb
咑	bgkl
囸	bgkl
囤	bgkx
圜	bgmq
圌	bgms
圛	bgmu
圐	bgmy
囬	bgnj
㘡	bgnp
㘠	bgpt
恩	bgpu
囫	bgqe
欭	bgqw
啪	bgrn
囮	bgrx
圂	bgse
囨	bgsl
慁	bgsp
囿	bgsq
囷	bgtd
图	bgtu
圈	bguc
唞	bguf
圏	bguv
図	bguw
囙	bgv
囻	bgva
圕	bgvn
㤙	bgvp
圍	bgvt
㘝	bgvy
圇	bgwf
囚	bgwg
囶	bgwj
圙	bgwj
囧	bgwm
囹	bgwp
朙	bgwq
囵	bgwx
㘥	bgwx
圀	bgwy
龱	bgwy
囼	bgxb
圞	bgxd
圗	bgxj
囡	bgxk
圎	bgxm
圝	bgxx
囜	bgxy
吋	bgy
圁	bgy
囥	bgym
啦	bgyu
呈	bh
㕵	bh
戢	bhat
郢	bhc
㖿	bhc
𠳐	bhc
囓	bhcl
喫	bhcs
噄	bhcx
咠	bhd
咡	bhd
哢	bhf
囁	bhhh
嚖	bhhp
嘒	bhhv
噖	bhhv
唪	bhjl
㕩	bhl
啧	bhmw
嘖	bhmw
㖺	bhn
啨	bhq
㗦	bhqc
嗪	bhtd
嚽	bhtm
嗷	bhtw
唛	bhtw
嗫	bhvv
㖩	bhvy
嗉	bhx
口	bi
〇	biii
唦	biit
嘡	bij
唢	bimw
嗩	bimw
噹	binb
哨	biq
㖄	bir
咣	bisx
吵	bit
㘍	bita
㗂	bitm
嗨	bitx
啵	bivv
嘙	bivx
嚐	bixn
吐	bj
咭	bjb
㘆	bjba
嘻	bjbb
嘭	bjbe
嘟	bjc
哮	bjck
哋	bjcl
嘋	bjct
呩	bji
味	bjiw
哇	bjj
㘑	bjji
啩	bjjl
嘵	bjjs
叿	bjl
唝	bjmw
嗊	bjmw
啫	bjn
噎	bjpu
啈	bjuj
嚋	bjvg
唗	bjw
呋	bjwg
哧	bjwr
㖫	bjwt
嚇	bjww
咾	bjx
嗑	bjxm
嗜	bjxn
呍	bjxy
呿	bjxy
呵	bkb
喇	bkbn
嗽	bkbq
囔	bkbq
嗝	bkbu
哣	bkbu
咞	bkf
吁	bkg
叮	bkl
吓	bklg
嘕	bklo
嘈	bkmn
唡	bkmw
啢	bkmy
囇	bkmy
哶	bknf
咧	bkng
㖦	bkni
咺	bknk
噁	bknp
𫫇	bknp
哑	bknu
唖	bknu
啞	bknu
哽	bknw
㖔	bksb
㖭	bksi
㗺	bksn
呒	bksx
吴	bksy
呯	bkuk
㕶	bkv
唔	bkvb
啑	bkvl
咦	bkvw
啛	bkvx
号	bkx
㙱	bkxj
號	bkxm
鴞	bkxq
鸮	bkxq
噸	bkxs
䪽	bkxs
饕	bkxw
飸	bkxw
吨	bkxx
咓	bkxy
虽	bl
中	bl
㐃	bl
踐	blaa
䟙	blac
䠞	blai
跮	blaj
㖸	blak
跷	blas
践	blat
噦	blat
距	blav
䟠	blax
呫	blb
躁	blbd
䠤	blbf
踀	blbl
蹪	blbm
䠝	blbm
噳	blbs
䠅	blbt
跏	blcb
䟳	blcc
跥	blcd
蹘	blce
躍	blcr
踺	blcv
趿	blcy
跴	bldg
蹅	bldk
蹮	bldv
䟣	bldy
䟰	bleg
䟬	blek
蹝	blel
蹤	blel
踬	blem
踲	blem
蹏	blem
躓	blem
跅	bley
跍	blfb
蹃	blfb
蹀	blfd
踑	blfh
䠜	blfh
躇	blfj
蹛	blfm
踖	blfn
躤	blfn
䠒	blfq
躏	blfr
躪	blfr
䠰	blfr
跂	blfv
蹒	blfw
蹎	blfw
跇	blfx
踸	blfx
蹣	blfy
卟	blg
䟷	blge
䟵	blgy
䠆	blha
踌	blhg
躡	blhh
䠫	blhi
蹟	blhm
踳	blhn
蹖	blhr
蹑	blhv
踙	blhv
踂	blhx
䠀	blib
蹚	blij
踏	blin
踃	bliq
䠌	bliq
嚬	blis
䟞	blit
踋	bljc
踍	bljc
跱	bljg
躊	bljg
跊	blji
跬	bljj
踛	bljj
踷	bljn
䟚	bljr
蹺	bljs
踜	bljt
趺	bljw
跿	bljw
䟩	bljx
嚱	blka
跒	blkb
䣒	blkc
趼	blkf
趶	blkg
踈	blki
䟱	blki
踁	blkj
咔	blkl
踕	blkl
䟓	blkl
䟼	blkl
贵	blkm
貴	blkm
䠭	blkm
䟛	blkm
踾	blkn
蹧	blkn
囐	blks
䫭	blks
跠	blkw
躎	blkw
躧	blky
䠃	blky
足	bll
跕	bllb
䠕	blld
踔	bllf
䟔	bllg
趾	blll
䠡	bllm
躆	blls
踄	bllt
䠩	bllt
踧	bllv
跐	bllx
踻	blmb
跺	blmd
唬	blmg
跙	blmh
跚	blmk
躅	blml
盅	blmn
蹦	blmq
躣	blmr
踹	blms
䠐	blms
躩	blmv
䟝	blmv
䟺	blmw
䟜	blmw
䠄	blmw
䟖	blmx
䟧	blnb
蹋	blnc
踝	blnd
踢	blne
踼	blne
啅	blnf
䠊	blnf
蹕	blnj
踶	blnl
嚧	blnm
跩	blnt
嘘	blnu
蹼	blnu
噓	blnu
跳	bloq
蹐	bloq
躞	blov
蹥	blpa
踠	blpc
䠚	blpe
跹	blpf
蹁	blpf
踪	blpj
蹿	blpl
蹜	blpn
跶	blps
䟤	blpt
忠	blpu
躂	blpu
蹆	blpv
躚	blpv
䠉	blpv
跎	blpx
躥	blpx
啃	blq
跀	blq
䟗	blqa
跔	blqb
跪	blqc
䟸	blqf
跞	blqi
䟢	blqi
踭	blql
蹓	blqn
蹨	blqo
跢	blqq
踘	blqu
跑	blqv
趵	blqy
䟡	blqy
䠨	blqy
䠋	blrf
跗	blrg
踓	blrl
雖	blrl
䠗	blrs
䟮	blrs
躈	blrt
䠘	blrx
跖	bls
踎	blsb
踦	blsb
噱	blse
蹰	blsg
蹽	blsi
䠑	blsj
䟴	blsj
㘌	blsn
蹶	blsq
躘	blst
跨	blsx
跋	blsy
路	bltb
踟	bltb
蹻	bltb
趷	bltc
跦	blti
踵	bltj
䟭	bltl
躜	bltm
躦	bltm
䟯	bltm
䠦	bltn
踿	blto
䟪	bltp
鹭	bltq
跣	bltq
鷺	bltq
跃	blts
跭	bltt
躌	bltt
嘑	bltu
䟦	bltv
跌	bltw
踇	bltx
踒	bltx
踽	blty
䠖	blub
踯	bluc
踡	bluc
躑	bluc
躢	bluc
䠓	blud
跰	bluf
蹲	blug
躝	blui
蹉	bluj
跘	bluj
蹭	blun
踫	blun
躙	blur
䠔	blus
蹸	blut
躨	blut
䠥	blut
䠮	bluv
噛	blux
䟨	blva
䠎	blva
跼	blvb
蹫	blvb
踴	blvc
䠬	blvc
蹂	blvd
踞	blvf
䟿	blvh
䠈	blvi
䠧	blvj
䠱	blvl
踊	blvm
蹳	blvm
䠇	blvm
跁	blvn
跽	blvp
跟	blvq
蹍	blvq
䠏	blvs
䟥	blvt
蹬	blvu
跛	blvv
䟾	blvv
䠍	blvv
趹	blvw
䠣	blvw
跜	blvx
躃	blvy
㕜	blvy
䟕	blvy
趴	blw
啮	blw
嚙	blw
跲	blwb
蹌	blwb
跄	blwc
蹹	blwc
踩	blwd
跈	blwe
踚	blwf
䠯	blwf
䟹	blwg
跧	blwh
䟶	blwj
踨	blwl
蹯	blwn
踰	blwn
跉	blwp
踗	blwp
蹈	blwr
蹊	blws
䠛	blwt
䟻	blwt
趻	blwv
呲	blx
跆	blxb
喍	blxd
躒	blxd
跸	blxf
蹡	blxg
䠁	blxj
躖	blxk
躀	blxm
嘴	blxq
蹞	blxs
踆	blxt
𧿹	blxu
躐	blxx
䠪	blxx
㗪	blxx
踮	blyb
踣	blyb
趽	blyc
踤	blyf
蹢	blyf
躕	blyg
㗔	blyg
跓	blyh
躔	blyj
蹱	blyj
蹄	blym
䟘	blym
蹠	blyo
躟	blyq
䟲	blyq
跻	blyr
躋	blyr
䟽	blyr
蹴	blys
蹾	blyt
踱	blyv
踉	blyv
跤	blyw
跡	blyw
踥	blyx
蹗	blyx
䠙	blyy
员	bm
郧	bmc
鄖	bmc
勋	bmct
勛	bmct
哚	bmd
嗣	bmfc
翤	bmfc
㖆	bmfk
噥	bmfs
唺	bmfw
叽	bmg
咀	bmh
員	bmii
呥	bmj
嚜	bmj
啁	bmjb
㘁	bmju
哃	bmkb
噮	bmkq
吊	bml
嚸	bmlb
咄	bmm
䚋	bmmq
㘗	bmmr
嘪	bmmw
嘤	bmmx
嚶	bmmx
呬	bmn
嘿	bmo
嗗	bmp
哯	bmqg
噣	bmql
嘣	bmqq
鶰	bmqx
啰	bmqy
哕	bmqy
嗺	bmrl
啱	bms
嘊	bmsj
喘	bmsm
䫟	bmsw
咉	bmsy
吶	bmty
囎	bmun
吺	bmv
喎	bmvb
呗	bmw
唄	bmw
㖵	bmw
呐	bmwg
呙	bmwg
剐	bmwn
㖗	bmwv
囉	bmxr
㕨	bmy
㗄	bmyc
嗮	bndg
啡	bnf
嚗	bnfi
嗶	bnfj
哻	bnfl
嘬	bnhv
哩	bnj
㖏	bnj
嘢	bnjv
呾	bnk
啺	bnke
㖷	bnkl
喂	bnkq
呻	bnl
嗢	bnmn
喁	bnmy
唱	bnn
呷	bnp
喟	bnq
喝	bnqw
嚉	bnug
噗	bnuh
㗼	bnuh
黾	bnx
𫑡	bnxc
㖂	bnxt
喅	bnyu
嘮	booc
㘇	bood
㗵	booq
啖	boow
咷	boqg
吙	bow
喗	bpaf
嗹	bpaf
㗧	bpaj
㗌	bpaj
呝	bpcg
噻	bpfj
㘔	bpfm
㗷	bpfm
啶	bpg
嗐	bphb
啌	bpjl
唍	bpjq
噠	bpju
喧	bpkk
咛	bpkl
㗻	bpmb
㕴	bpmg
嚃	bpmi
嚺	bpms
嚀	bppk
嘧	bppm
哝	bpq
啘	bpqc
㕪	bpqg
嚓	bpqj
唳	bpsu
哒	bpsy
咇	bpt
咤	bpta
喀	bptb
哰	bptl
鿽	bptl
㗓	bptv
吣	bpu
嗵	bpvm
咜	bpx
咹	bpxk
噾	bpyn
肙	bq
㖧	bqan
呧	bqay
呴	bqb
㒭	bqbq
嚵	bqby
嚠	bqcn
嘄	bqd
吻	bqe
唿	bqep
兄	bqg
䶷	bqg
㗫	bqji
噜	bqkn
瓹	bqky
唃	bqm
唤	bqms
喚	bqms
咰	bqn
剈	bqng
呜	bqo
嗚	bqo
嚕	bqon
喣	bqow
焁	bqow
鹃	bqqx
鵑	bqqx
哆	bqqy
啗	bqrj
嘫	bqso
㗋	bqst
噡	bqsy
㕤	bqt
啕	bqtm
呁	bqu
嘝	bquf
咆	bqv
喼	bqvp
吹	bqw
哅	bqwx
鸣	bqx
鳴	bqx
㕼	bqxw
㗙	bqxx
唣	brag
响	brb
呂	brb
嗰	brbf
咃	brcl
咻	brd
㗱	brd
啤	brfg
唕	brfg
咐	brgy
喤	brh
哬	brkb
唯	brl
咱	brm
㕷	brn
嚊	brnr
嘷	brof
噑	brof
噍	brow
㗹	brpu
唲	brqg
鷕	brqx
啲	brqy
嗥	brsf
嗅	brsu
喺	brtx
㘀	brud
噢	brus
喉	brvt
咿	brvt
嗖	brvy
㖬	brvy
吪	brx
喞	brxc
哗	brxf
噭	bryt
喕	bsbj
呃	bsc
呖	bsct
啄	bse
哤	bse
喯	bsff
嗕	bsgy
㖘	bsj
㖠	bsji
喹	bsjj
啀	bsjj
咗	bsjl
咵	bsjx
呸	bsk
㗏	bskl
吥	bsl
㖇	bsm
嘎	bsma
嘠	bsma
咘	bsml
嗄	bsmt
嚘	bsmt
咟	bsn
喱	bsnj
嚈	bsns
唵	bsnx
咴	bsow
哊	bsq
喐	bsqc
咙	bst
嚨	bst
嚦	bstl
吠	bsu
嘹	bsui
噘	bsuq
㗞	bsvv
㕹	bsvy
㖽	bsw
唊	bsww
㕱	bsx
吰	bsxy
呔	bsy
㕦	bsy
㗐	bsym
㕰	bta
吒	btag
哦	btat
咯	btb
啝	btb
啣	btc
吃	btcg
唀	btcp
咊	btd
呏	btf
吀	btfg
唾	btfk
嘸	btfo
喢	btfr
㖓	bthl
咮	btiw
哠	btj
噬	btjw
吘	btk
㗢	btkc
㗑	btkh
喠	btkj
嚑	btko
吽	btl
咋	btlg
喒	btln
嚹	btlu
咶	btm
囖	btmr
㗍	btn
唎	btng
啾	btow
囋	btqm
嚟	btqw
嘺	btsb
㕭	btsy
哖	bttj
㗛	btts
咚	btu
呼	btuk
㘉	btvc
呚	btw
㗳	btwb
呹	btwg
唩	btxk
䶸	btxy
叺	bty
喩	btyx
啳	buc
咪	bud
噂	budg
呌	bufg
咩	buh
嗟	bujl
㗿	bukb
㘓	buki
吖	bul
噌	bumn
啴	bunf
㗝	buow
哾	buq
㗴	buq
嚪	buqr
噒	buqt
咲	busy
㖒	buvt
㘎	buvt
㘚	buvt
嗛	buw
嗌	buwm
唥	buwp
唴	bux
喽	buxk
嘍	buxk
㘂	buxp
嗍	buxq
嗞	buxx
嗴	buxx
吗	bv
嗎	bv
呡	bvag
喔	bvaj
㗃	bvan
嘅	bvaq
喡	bvbt
䣈	bvbv
噼	bvby
唧	bvc
吜	bvf
啹	bvfb
㖊	bvgy
㖨	bvh
噉	bvht
囑	bvil
啸	bvir
㖤	bvix
噚	bvjg
㗲	bvjk
㗇	bvjv
噔	bvku
吲	bvl
㖀	bvl
嚍	bvlm
嘯	bvlr
㗈	bvmc
啒	bvmm
唰	bvmn
吧	bvn
邑	bvn
唚	bvpv
哏	bvq
咈	bvr
吚	bvt
㕧	bvt
噊	bvtb
㖻	bvtd
嘱	bvty
嘨	bvur
嗓	bvvd
㗶	bvvm
啜	bvvv
噀	bvvw
吷	bvwg
呢	bvx
叹	bvy
呎	bvy
㘐	bvyw
只	bw
叭	bw
唫	bw
哈	bwb
噞	bwbw
呛	bwc
噏	bwcc
哹	bwck
㖹	bwcm
吩	bwco
啂	bwcx
啋	bwd
嘦	bwdx
啽	bwf
㕥	bwg
哷	bwgy
㘴	bwj
哙	bwjx
喛	bwkv
㖉	bwll
㖮	bwmf
嚼	bwmg
噲	bwmn
噃	bwn
呤	bwp
噯	bwpt
㗭	bwpu
嗳	bwpv
㖟	bwpv
喻	bwqn
㰨	bwqw
吤	bwr
㗖	bwrj
唏	bwsm
㘛	bwst
㖁	bwsx
唋	bwt
嗱	bwtg
啥	bwtm
嗂	bwtm
噅	bwto
喰	bwv
唂	bwwb
唑	bwwj
嗲	bwwq
㕮	bwwy
嗡	bwxc
哸	bwxk
㕳	bwxl
嗘	bwxs
㕬	bwxy
史	bwy
唅	bwyb
嗆	bwyb
嗿	bwym
唸	bwyp
吟	bwyv
噙	bwyx
叱	bx
咍	bxb
嗈	bxbv
嚩	bxdg
嗤	bxkl
呉	bxkw
叫	bxl
㖰	bxmb
吮	bxqg
哟	bxqy
喲	bxqy
喙	bxse
吳	bxsy
哞	bxtl
唉	bxts
㘈	bxtv
呣	bxu
呶	bxvy
哛	bxwc
㖎	bxwr
唆	bxwt
吡	bxx
噝	bxx
呦	bxxc
嚛	bxxd
嘇	bxxe
哔	bxxf
咝	bxxk
㗀	bxxm
喈	bxxr
嘰	bxxw
吆	bxxy
㕽	bxyw
唁	by
㖣	byb
嗃	bybb
哼	bybc
啍	bybc
㗥	bybc
喨	bybm
嚷	bybq
㗒	bybq
嚎	bybs
噈	bybs
噋	bybt
啷	byc
㕫	byc
嚌	bycr
嘛	bydd
噺	byde
嚫	bydq
嚰	byds
嚤	bydt
嚒	bydx
㖕	byf
嗻	byfo
喥	byfv
嚝	byfw
呅	byg
咏	byio
㖢	bylx
嘀	bymf
吭	bymg
喑	byn
噇	bynj
啼	bypm
噫	bypu
嗙	bypy
噷	byqw
哜	byr
㖡	byry
喭	byse
㘖	byss
嗾	bytt
㕸	byu
哴	byv
嘃	byvl
啐	bywf
囃	bywr
囄	bywr
唹	bywu
咬	byww
唼	byxk
㗜	byxn
唷	byxq
噰	byxr
咳	byxw
呟	byxx
了	c
䧖	caat
䧢	cabb
䧕	cabk
阵	caf
陣	caf
陈	caiw
塦	caj
隇	cakx
隁	canx
陿	casw
司	cb
叾	cb
廻	cbb
孠	cbck
䦿	cbl
隤	cblm
𬯎	cblm
陨	cbm
隕	cbm
覗	cbmq
廽	cbnj
䧎	cbq
亟	cbvk
焏	cbvo
凾	cbvx
䛐	cby
羽	cc
䎒	ccaa
䎉	ccak
䎀	ccax
䧂	ccb
翀	ccbl
䎌	ccbl
䣁	ccc
䎔	ccdg
䎍	ccdu
羿	ccf
阠	ccfg
翄	ccfv
䍿	cch
䎚	cchp
䎎	cchx
䎓	ccin
羾	ccjl
䦻	cck
阤	ccl
翨	ccnl
䎈	ccnt
翼	ccnw
翚	ccpa
翬	ccpa
翴	ccpa
翑	ccqb
翆	ccqf
䎂	ccqv
翵	ccqx
戳	ccra
㦻	ccra
翟	ccrl
飁	ccrl
習	ccrn
翫	ccrq
鸐	ccrq
翭	ccrt
㪬	ccrv
翜	ccsw
頨	ccsw
翇	ccsy
阞	cct
毣	ccta
翐	cctw
䎑	ccvh
翍	ccvv
戮	ccwa
勠	ccwc
翂	ccwc
鄝	ccwc
翏	ccwe
剹	ccwn
䎆	ccwp
鹨	ccwq
鷚	ccwq
雡	ccwr
顟	ccws
翪	ccwt
翯	ccyb
翠	ccyf
翞	ccyi
翌	ccyu
翋	ccyu
翣	ccyx
廼	cdg
䧈	cdg
䧠	cdgy
陻	cdj
䧣	cdji
䧥	cdpu
隭	cdsm
陠	cdu
䧒	cdww
阪	cevy
隫	cffm
䦹	cfg
䧆	cfw
乙	cg
卂	cgfg
蝨	cgfl
鳵	cgfq
氹	cgio
丮	cgjl
厾	cgjx
乪	cgnb
虱	cgtl
飞	cgu
飛	cguu
飝	cguu
陦	chgy
隞	chtw
陬	chvy
廴	ciii
阝	ciii
卩	ciii
㔾	ciii
隚	cij
隙	cini
阥	cio
陗	ciq
隲	citv
那	cjc
际	cji
隢	cjjs
陼	cjn
阮	cjqg
阱	cjr
隯	cjvg
陡	cjw
陸	cjwj
陵	cjwt
陆	cjxl
阹	cjxy
子	ck
刁	ck
孒	ck
陚	ckal
阿	ckb
隔	ckbu
娿	ckbx
孨	ckcc
孖	ckck
孴	ckcn
孺	ckds
孤	ckex
㝂	ckge
孑	ckii
孙	ckiw
㝆	ckjb
孲	ckkn
䦺	ckl
阷	ckll
勐	ckmc
孟	ckmn
孭	ckmw
陃	ckmw
孾	ckmx
陳	ckni
螴	cknl
敶	cknt
孮	ckpj
孞	ckpu
㝃	ckqq
孢	ckqv
愻	cktp
㤵	cktp
孜	cktw
孫	cktx
陕	ckus
㜿	ckvc
孻	ckvm
䧅	ckvw
㜾	ckwr
隬	ckww
孔	ckx
孡	ckxb
陘	ckxj
孩	ckyw
也	cl
阽	clb
陟	clit
骘	cliv
騭	cliv
卫	clk
隵	clka
卍	clkl
阯	cll
㢟	cll
䖎	clmg
乸	clxu
㢠	cmb
阻	cmh
䧓	cmjb
隑	cmku
䧋	cmqg
𬮿	cmvk
䧙	cmwi
阳	cn
䧃	cnb
陫	cnf
陧	cnj
䧉	cnj
陽	cnke
隄	cnkl
隈	cnkq
隅	cnmy
廸	cno
䧨	cnuh
䧤	cnuh
隰	cnxo
刀	co
召	cob
邵	cobc
劭	cobc
卲	cobc
㐒	cobc
䎄	cobc
刟	cobn
欩	cobq
䙼	cobq
䳂	cobq
巶	cobv
綤	cobx
刕	cocc
脋	cocq
鳭	coqx
阦	cow
刃	coy
刄	coy
丒	coyk
歰	coyl
忍	coyp
乃	cp
阸	cpcg
孕	cpck
朶	cpd
刴	cpdn
呄	cpfb
䧑	cpg
䧮	cphp
尕	cpiw
院	cpjq
㭆	cpkd
䧬	cpkm
盁	cpmn
鼐	cpmv
㚉	cpqq
随	cpsq
隨	cpsq
隧	cpus
戤	cpva
盈	cpvm
夃	cpvy
陀	cpx
及	cpy
㤂	cpyp
䲯	cpyq
阴	cq
阺	cqay
䧁	cqb
䧯	cqby
際	cqji
陥	cqln
﨩	cqmx
隖	cqo
䧰	cqox
陊	cqqy
陷	cqrj
陒	cqsc
陶	cqtm
陱	cqud
隐	cqvp
隝	cqx
隗	crb
陴	crfg
附	crgy
隍	crh
隉	crjl
陮	crl
廹	crn
𨺙	crqg
隩	crus
䧭	crwp
阨	csc
陙	csj
㯐	csjd
隳	csji
墮	csjj
隓	csjj
嶞	csjm
隋	csjq
陓	csjx
䜐	csjy
陭	cskb
阫	csl
陑	csm
陌	csn
陏	csq
堕	csqj
陾	cssy
陇	cst
隴	cst
陝	csty
陜	csww
阢	csx
䧀	csxy
力	ct
加	ctb
䧄	ctb
哿	ctbb
㔔	ctbb
乫	ctbc
架	ctbd
嗧	ctbf
贺	ctbm
賀	ctbm
㤎	ctbp
袈	ctbq
鴐	ctbq
㚙	ctbs
䂟	ctbs
毠	ctbt
㧝	ctbt
驾	ctbv
駕	ctbv
㔖	ctbv
㠰	ctbv
妿	ctbx
㖙	ctbx
䪪	ctby
劦	ctcc
阣	ctcg
陁	ctcl
䝱	ctcm
勰	ctcp
脅	ctcq
姭	ctcx
阩	ctf
阡	ctfg
陞	ctfj
陲	ctfk
陹	ctfn
䧏	cthl
陎	ctiw
廷	ctj
䧊	ctj
隀	ctkj
䃧	ctks
隆	ctkt
鿧	ctkw
郔	ctlc
阼	ctlg
延	ctll
蜑	ctll
䗺	ctll
䧗	ctnt
頲	ctsw
颋	ctsw
降	cttj
劜	ctx
习	cu
阧	cufg
隣	cuqt
隣	cuqt
隊	cuse
墜	cusj
鐆	cusw
䧧	cuta
隒	cuw
隘	cuwm
䧞	cv
隦	cvby
䦽	cvc
䧩	cvht
陉	cvj
隥	cvku
建	cvl
限	cvq
陂	cvv
䦼	cvwg
険	cwbw
險	cwbw
队	cwg
隂	cwha
险	cwik
坠	cwj
檃	cwjd
櫽	cwjd
隱	cwjp
陯	cwmf
阾	cwp
隃	cwqn
阶	cwr
䧟	cwrj
除	cwt
䧦	cwto
隠	cwvp
䧍	cwwb
䧌	cwxk
䧔	cwyp
陰	cwyx
乜	cx
廵	cxg
䧝	cxkl
陋	cxkw
𠙶	cxl
隟	cxnd
阭	cxqg
䧘	cxse
墬	cxsj
陖	cxwt
阰	cxx
陛	cxxj
階	cxxr
孓	cy
卪	cy
陪	cyb
䧚	cybb
䧐	cybc
䧫	cybs
防	cyc
隮	cycr
障	cyfg
埅	cyj
阬	cymg
隌	cyn
䧛	cypy
䧇	cyq
𬯀	cyr
隡	cyst
䧪	cysx
䧜	cyvb
䧡	cyvl
陔	cyxw
要	d
栕	da
棧	daat
樞	dabb
棫	dabk
櫃	dabm
㭨	dac
械	daf
框	dah
㰉	daht
栋	daiw
桎	daj
栻	dajl
樲	dajm
椷	dakb
楲	dakx
枒	dal
槭	dali
㰗	dall
榧	danf
椡	dang
㭱	danp
椻	danx
橬	daqn
柩	daqy
㭜	das
桡	dasx
栈	dat
桟	dat
檻	datm
㰓	datm
欖	datq
㰖	datq
㮹	datw
柜	dav
樫	davj
枢	dawy
㮜	daxj
杙	day
杏	db
槶	dbak
梠	dbb
榀	dbbb
楍	dbbb
橾	dbbd
樿	dbbf
梙	dbbl
槵	dbbp
欕	dbbt
㮙	dbbx
㭭	dbcn
枴	dbco
柺	dbct
梱	dbd
檲	dbdg
棝	dbfb
栶	dbg
桯	dbh
檝	dbha
楫	dbhd
椢	dbhy
枵	dbkx
樻	dblm
㯝	dblt
梋	dbq
柷	dbqg
㮯	dbse
棞	dbtd
枳	dbw
榲	dbwm
䢶	dc
枷	dcb
柖	dcb
柌	dcb
極	dcbk
栩	dcc
栛	dccc
桗	dcd
杨	dce
㭄	dcfg
朰	dcg
梛	dcjc
李	dck
杍	dck
樄	dcki
杝	dcl
朷	dco
㭁	dcp
㰐	dcpq
櫂	dcrl
槢	dcrn
椭	dcsq
橢	dcsq
朸	dct
梃	dctj
梴	dctl
槂	dctx
榌	dcuu
楗	dcvl
楹	dcvm
樛	dcwe
极	dcy
杒	dcy
㯁	dcyb
梕	dcyp
林	dd
櫺	ddbb
䠂	ddbl
欞	ddbw
郴	ddc
㯬	ddcv
森	ddd
㯲	dddj
檚	dddv
彬	dde
㯄	ddev
欛	ddfq
栖	ddg
榑	ddgy
槫	ddgy
樷	ddhv
埜	ddj
㮒	ddj
㯹	ddjg
禁	ddji
標	ddji
㮏	ddji
檦	ddjn
㱈	ddjq
䫴	ddjs
樗	ddjx
橒	ddjx
梄	ddk
梺	ddkl
㪔	ddlv
檒	ddml
槚	ddmw
檟	ddmw
梵	ddmy
檑	ddnb
榃	ddnb
橝	ddnf
楂	ddnk
焚	ddow
槱	ddow
樮	ddow
㷊	ddow
椘	ddp
㰈	ddpa
棾	ddpm
橞	ddpu
㭝	ddqt
梦	ddqy
㰌	ddrl
辳	ddsj
檽	ddsm
䫐	ddsw
㭪	ddu
㯨	ddud
樰	ddvh
㯟	ddvh
楚	ddvl
棼	ddwc
㯃	ddwi
㯪	ddwp
棽	ddwv
棶	ddww
婪	ddxk
楆	ddxk
麓	ddyx
杉	de
椞	ded
櫍	deem
楯	defm
𬃊	defm
桁	deg
椼	dei
枛	dei
析	dek
栀	dekc
栃	dekc
梔	dekv
梹	dekw
蜤	del
榹	delm
㮽	demv
晳	den
梑	deow
惁	depu
㭛	deq
皙	dern
板	devy
樅	dewl
柧	dex
柝	dey
欌	dfaa
櫙	dfab
枯	dfb
槿	dfbh
欟	dfbq
權	dfbr
㰙	dfbr
栉	dfc
楳	dfd
㯦	dfd
㯕	dfek
枿	dff
㮖	dff
楛	dffb
橨	dffm
棋	dfh
榵	dfhd
欂	dfig
柑	dfj
樭	dfj
㯼	dfjm
樺	dfkj
橫	dfkw
杆	dfl
植	dfmh
構	dfmj
㯖	dfmp
楧	dfms
㰜	dfms
槙	dfmw
樠	dfmy
櫗	dfmy
棤	dfn
橶	dfna
檊	dfnf
㰇	dfnk
橗	dfnq
模	dfns
横	dfnw
櫣	dfpa
㯴	dfpb
桲	dfpc
㮠	dfpd
檬	dfps
㮦	dfpx
楜	dfq
櫒	dfqj
㯂	dfqm
槆	dfqn
檧	dfqp
橵	dfqt
㯳	dfqt
﨓	dfrg
櫵	dfro
欍	dfrr
檴	dfrv
椛	dfrx
楉	dfsb
樥	dfth
㯵	dftj
㮱	dftq
楠	dfu
樯	dfub
欗	dfui
㟚	dfvm
櫹	dfvr
椟	dfvs
枝	dfvy
栱	dfw
檋	dfwa
榙	dfwb
㯣	dfwd
椹	dfx
枻	dfx
櫀	dfx
楪	dfxd
㰛	dfxd
㭶	dfyc
橭	dfyf
㯜	dfyf
西	dg
栗	dgd
鷅	dgdq
覆	dget
覉	dgfb
覇	dgfq
覊	dgfv
襾	dgii
覀	dgii
垔	dgj
鄄	dgjc
勡	dgjc
翲	dgjc
瓢	dgje
彯	dgje
票	dgji
䙵	dgjj
飄	dgjl
剽	dgjn
歅	dgjq
䚈	dgjq
顠	dgjs
飘	dgjw
甄	dgjy
㼼	dgjy
㶾	dgko
贾	dgmw
賈	dgmw
覃	dgnf
鷣	dgnq
䚓	dgnq
䙳	dgow
梂	dgoy
䙶	dgpq
覄	dgrs
覈	dgrt
䙴	dgsv
䙲	dgsy
材	dgt
䅇	dgtd
覂	dgtp
粟	dgud
㔄	dgun
䊲	dgut
覅	dgxe
要	dgxk
䳩	dgxq
村	dgy
枉	dh
枨	dha
棖	dha
櫮	dhbb
檉	dhbh
椰	dhc
梆	dhc
楔	dhcs
㮮	dhct
栮	dhd
梇	dhf
㭅	dhg
梼	dhgy
欇	dhhh
櫘	dhhp
槥	dhhv
棒	dhjl
楱	dhks
㭋	dhl
樍	dhmw
椿	dhn
棈	dhq
樁	dhrj
榛	dhtd
棷	dhvy
榡	dhx
㭯	dhx
木	di
橕	dial
橖	did
朩	diii
桫	diit
樘	dij
㭻	dimb
欓	dimo
㭼	din
檔	dinb
𣗋	dip
梢	diq
栦	dir
桄	disx
杪	dit
㭞	ditc
㮐	ditm
档	divh
㭂	diw
樑	diwd
榉	diwj
﨔	diwt
桜	dixk
杜	dj
樾	djax
桔	djb
檯	djba
橲	djbb
樹	djbg
榬	djbq
桏	djc
㭏	djc
㯧	djcb
㭳	djck
㭙	djgy
标	dji
柰	dji
柡	djio
㭑	djiw
桂	djj
㯘	djjq
橈	djjs
栲	djkx
杠	djl
杢	djl
㮪	djmd
櫝	djmm
槓	djmw
楮	djn
榸	djnj
㯛	djpn
梽	djpu
杬	djqg
歀	djqw
㲡	djta
檮	djvg
隸	djvi
檣	djwb
枎	djwg
櫕	djwm
㰊	djwo
槻	djwq
棱	djwt
槸	djwy
栳	djx
杇	djx
榼	djxm
榰	djxn
枟	djxy
㭕	djxy
本	dk
醆	dkaa
醎	dkab
醧	dkab
䤐	dkan
䣬	dkat
䣰	dkav
䣧	dkay
柯	dkb
㮺	dkbb
酲	dkbh
梀	dkbi
櫴	dkbm
醞	dkbm
楅	dkbn
楋	dkbn
樕	dkbq
欜	dkbq
䣺	dkbq
釅	dkbt
梪	dkbu
槅	dkbu
䣳	dkcb
翉	dkcc
醪	dkce
酏	dkcl
杤	dkct
䣦	dkct
枺	dkd
醽	dkdb
醂	dkdd
醰	dkdf
醥	dkdj
醹	dkds
酺	dkdu
枅	dkf
酤	dkfb
䤀	dkfb
䤂	dkfd
醛	dkfh
䤊	dkfh
酣	dkfj
酐	dkfl
醋	dkfn
㭢	dkfn
醼	dkfo
醐	dkfq
䤓	dkfs
䣫	dkfv
䤑	dkfw
䤁	dkfx
䤍	dkfy
杅	dkg
酎	dkgy
䣵	dkhd
酉	dkii
酬	dkir
酵	dkjc
醻	dkjg
醘	dkjm
醏	dkjn
酛	dkjq
酜	dkjw
酝	dkjx
酠	dkkb
酑	dkkg
酊	dkkl
䣪	dkkm
䣿	dkkm
醩	dkkn
酽	dkkt
䣩	dkkx
酾	dkky
釃	dkky
朾	dkl
酟	dklb
柾	dkll
㯊	dklo
醵	dkls
酮	dkmb
䣯	dkmh
楝	dkmi
栜	dkmi
杮	dkml
醠	dkmm
槽	dkmn
醲	dkms
醴	dkmu
醳	dkmu
酘	dkmv
柄	dkmw
欐	dkmy
栵	dkng
棟	dkni
䤖	dkni
桓	dknk
橿	dknk
醍	dknl
醖	dknm
榗	dknn
橊	dknn
醒	dknt
䤏	dknt
桠	dknu
醭	dknu
椏	dknu
梗	dknw
醌	dknx
醈	dkoo
酧	dkpg
醡	dkpl
醓	dkpm
䣾	dkpm
䤉	dkpm
酖	dkpq
𬪩	dkpq
醚	dkpu
䤇	dkpv
酡	dkpx
酩	dkqb
䣱	dkqb
酔	dkqf
醄	dkqt
酌	dkqy
䣹	dkra
醜	dkrb
醀	dkrl
醮	dkro
醙	dkrv
㮇	dksi
䤄	dksj
醢	dksm
酭	dksq
䣭	dksu
醃	dksx
酞	dksy
䣮	dksy
酕	dkta
䣨	dkta
酪	dktb
酥	dktd
䣷	dkti
酷	dktj
酢	dktl
枾	dktl
䣶	dktm
醺	dkto
酰	dktq
桺	dktv
酶	dktx
梾	dkud
酙	dkuf
醝	dkuj
枰	dkuk
𬂩	dkus
梧	dkvb
䤎	dkvb
醁	dkvh
配	dkvk
醱	dkvm
醑	dkvq
醗	dkvq
䤆	dkvs
醊	dkvv
桋	dkvw
棲	dkvx
䣻	dkwb
䤌	dkwb
酚	dkwc
酻	dkwc
酹	dkwg
釂	dkwg
酫	dkwh
䤘	dkwk
䤈	dkwm
䤅	dkwn
䣴	dkwq
酴	dkwt
檷	dkww
醶	dkww
酗	dkwx
杖	dkwy
朽	dkx
䣥	dkx
䤕	dkxd
醦	dkxe
䣲	dkxf
桱	dkxj
枑	dkxk
䤙	dkxl
酯	dkxn
酳	dkxq
酸	dkxt
䤒	dkxw
杶	dkxx
酦	dkxy
醅	dkyb
醣	dkyb
醇	dkyc
醉	dkyf
䣼	dkyi
醯	dkym
醕	dkyn
釄	dkyn
䤃	dkyn
醷	dkyp
醸	dkyq
釀	dkyq
酼	dkyr
醾	dkyu
酿	dkyv
醨	dkyx
醿	dkyx
檅	dlat
枮	dlb
樐	dlbo
朴	dlg
㰋	dlis
桛	dljl
椒	dlkv
杫	dll
螙	dll
椃	dlmg
樝	dlmh
桢	dlmw
楨	dlmw
㯭	dlnc
槕	dlnd
棹	dlnf
櫨	dlnm
櫖	dlnp
㯫	dlse
㯉	dltu
栌	dlvt
橴	dlxx
榩	dlyg
相	dm
㭎	dm
㰄	dmaa
柵	dmf
欁	dmfd
㯰	dmfm
檂	dmfs
椣	dmfw
机	dmg
柤	dmh
査	dmh
柟	dmj
椆	dmjb
枏	dmjg
檡	dmju
桐	dmkb
檈	dmkq
榿	dmku
柮	dmm
栅	dmmk
欋	dmmr
欔	dmmv
樱	dmmx
櫻	dmmx
柶	dmn
㭗	dmn
檌	dmnf
榾	dmp
想	dmpu
枧	dmqg
梘	dmqg
㯮	dmql
椤	dmqy
欈	dmrb
㰎	dmrc
槯	dmrl
椯	dmsm
柍	dmsy
楓	dmtl
棡	dmum
棢	dmuy
杸	dmv
楇	dmvb
桤	dmvk
梖	dmw
椇	dmw
梤	dmwc
枘	dmwg
梣	dmwv
枫	dmwy
杣	dmx
欏	dmxr
檙	dmxv
杋	dmy
枬	dmy
楞	dmyc
鿝	dmyw
杳	dn
榻	dncc
㭷	dnct
棵	dnd
棑	dnf
㮿	dnfj
桿	dnfl
樶	dnhv
榥	dnis
梩	dnj
㯇	dnj
榯	dnjg
查	dnk
柦	dnk
楊	dnke
棏	dnkg
㮛	dnkl
椳	dnkq
鸉	dnkq
皶	dnkv
梬	dnkx
柛	dnl
榅	dnmn
槾	dnmv
椙	dnn
橸	dnnn
櫑	dnnn
欙	dnnx
柚	dno
柙	dnp
楒	dnpu
㭿	dnqc
楬	dnqw
槛	dntm
榄	dntq
樸	dnuh
檏	dnuh
欉	dnuv
㭴	dnvj
楐	dnwr
㮨	dnwt
樏	dnx
栧	dnxt
棍	dnxx
雨	do
霵	doba
霝	dobb
䨓	dobb
酃	dobc
霣	dobm
䚖	dobq
䴒	dobq
䰱	dobr
龗	dobs
露	dobt
㪮	dobv
靈	dobw
孁	dobx
䨒	docc
䨯	doci
䨸	docp
霫	docr
霆	doct
霳	doct
䬠	docu
雭	docy
雬	dod
霖	dodd
霦	dode
䨛	dode
霜	dodm
鸘	dodq
鹴	dodq
䨫	dodt
䨷	dodv
霺	doet
䨱	doet
䨣	doff
雸	dofj
霸	dofq
霙	dofs
靀	dofs
霰	doft
䨢	dofx
䨝	dohq
靊	dohu
䨮	dohv
霑	doib
霘	doib
霂	doid
䨬	doid
䨵	doif
䨰	doif
䨕	doig
霔	doih
䨟	doij
靋	doil
霈	doim
霄	doiq
霃	doiq
䨔	dois
霪	doit
䨙	doit
霗	doiw
霟	doiw
霐	doix
霮	doix
霶	doiy
鄠	dojc
霴	doji
靆	doji
䨪	dojj
靅	dojm
霊	dojn
䨌	dojq
䨭	dojq
䨍	dojr
靉	dojt
霼	doju
霒	dojv
雩	dojx
雲	dojx
霕	dojx
䨺	dojx
㮓	dokk
雫	dokl
䨑	dokw
霋	dokx
霌	domb
䨘	domq
䨳	domq
雵	doms
霻	domu
雷	donb
霷	done
霏	donf
䨴	dong
靁	donn
靐	donn
䨻	donn
霬	donw
䨠	donw
鿨	donw
電	donx
檆	doob
櫿	doob
橯	dooc
橩	doom
雿	dooq
棪	doow
䨩	dopl
靌	dopm
䨤	dopn
靏	dopq
霥	dops
䨨	dopv
桃	doqg
霡	doqi
霤	doqn
䨚	doqp
霢	doqq
䨜	doqq
雹	doqv
㽌	doqy
檪	dord
霍	dorl
䨹	dorm
霓	dorq
靍	dorq
鸖	dorq
㱋	dorq
靃	dorr
䨥	dorv
雼	dos
雳	dosc
震	dosj
靂	dosl
需	dosm
䨖	dosq
䰰	dosr
颥	doss
顬	doss
靇	dost
䨲	dosy
雮	dota
䨋	dota
雾	dotc
雽	dotu
霉	dotx
䨞	doty
䨏	douq
霱	dovb
霧	dovc
霨	dovg
雪	dovh
霿	dovm
雺	dovt
霚	dovt
霯	dovu
霞	dovv
霛	dovv
䨎	dovx
䨡	dovx
霹	dovy
杰	dow
䨐	dowb
雰	dowc
䨗	dowc
霾	dowj
零	dowp
靎	dowq
䴇	dowq
䨶	doxv
霅	doy
雱	doyc
霩	doyc
雯	doyg
霁	doyr
霽	doyr
雴	doyu
霠	doyv
㰔	doyv
霭	doyw
靄	doyw
䨧	doyw
霎	doyx
䨦	doyy
梿	dpaf
楎	dpaf
槤	dpaf
榁	dpaj
槴	dpbv
㮼	dpcc
櫏	dpdv
槟	dpew
椗	dpg
㮫	dphb
櫶	dphp
棕	dpji
椌	dpjl
梡	dpjq
橽	dpju
㯈	dpki
楦	dpkk
柠	dpkl
檳	dpkm
㯾	dpkn
檛	dpmb
楄	dpmf
椬	dpmh
榊	dpnl
榠	dpnw
㰑	dppd
檸	dppk
櫁	dppl
樒	dppm
橣	dppm
椀	dpqc
枕	dpqg
檫	dpqj
榷	dprl
樎	dprn
槣	dpsb
榢	dpse
㯌	dpse
棙	dpsu
柲	dpt
㭦	dpta
楁	dptb
槰	dpth
榨	dptl
榓	dptm
槌	dptv
杺	dpu
檤	dpur
檖	dpus
㮸	dpus
棺	dpv
枦	dpv
樋	dpvm
㯽	dpvm
柼	dpw
榕	dpwb
棎	dpwd
㰂	dpwn
柁	dpx
桉	dpxk
椖	dpyc
榟	dpyf
㰅	dpyf
枂	dq
桰	dqab
棔	dqan
柢	dqay
枸	dqb
梚	dqbq
橡	dqbs
欃	dqby
㭸	dqby
枊	dqc
栁	dqc
桞	dqc
橮	dqcm
榴	dqcn
檞	dqct
棴	dqcv
楤	dqep
枠	dqfg
栎	dqiw
橹	dqkn
桷	dqm
㭥	dqmw
槝	dqmx
栒	dqn
㭵	dqnb
㮧	dqo
櫓	dqon
櫯	dqot
棚	dqq
栘	dqqy
桅	dqsc
橪	dqso
檐	dqsy
朹	dqt
柳	dqtc
榤	dqtd
桝	dqtj
枃	dqu
橳	dquc
椈	dqud
槲	dquf
㮳	dqus
枹	dqv
棦	dqvl
栬	dqvn
杴	dqw
樢	dqx
㭤	dqx
㮲	dqxx
构	dqxy
杓	dqy
杦	dqy
杊	dr
棩	dr
梍	drag
栰	drat
㭖	dray
槐	drb
椺	drbd
槜	drcp
榫	drfg
椑	drfg
榭	drgy
柎	drgy
楻	drh
椴	drhm
楾	drio
桕	drj
檓	drjm
櫸	drkj
㮉	drks
欅	drkt
楩	drkw
椎	drl
㮅	drl
檇	drlc
樤	drld
樇	drlq
棉	drml
㰃	drmx
柏	drn
㯷	drnu
槹	drof
橰	drof
樵	drow
㮩	drpu
櫋	drpy
棿	drqg
欆	drrv
槔	drsf
栿	drsu
栣	drtj
樬	drtp
櫆	druf
㭊	drv
梻	drvr
㮢	drvt
㮴	drvy
㰒	drwc
楰	drwg
㮰	drwx
㭡	drwy
杹	drx
梎	drx
桦	drxf
槪	drxq
檄	dryt
柘	ds
檶	dsab
桮	dsb
槗	dsbb
㮌	dsbj
枙	dsc
枥	dsct
㮟	dsd
椓	dse
㭬	dse
櫔	dsfy
槈	dsgy
桭	dsj
槬	dsje
櫉	dsjg
㮈	dsji
楏	dsjj
楕	dsjq
桍	dsjx
柸	dsk
椅	dskb
橱	dskg
杯	dsl
栫	dslc
栭	dsm
柨	dsml
㮎	dsmn
榎	dsmt
櫌	dsmt
栢	dsn
㭺	dsnx
栯	dsq
㮋	dsqc
榞	dsri
㰁	dsss
㮕	dssy
栊	dst
櫳	dst
櫪	dstl
枤	dsu
橑	dsui
橛	dsuq
柭	dsvy
梜	dsww
樉	dsww
杌	dsx
㮷	dsxn
杕	dsy
枆	dta
杔	dtag
格	dtb
椥	dtb
楀	dtby
杚	dtcg
柂	dtcl
柇	dtd
鬱	dtde
枡	dtf
杄	dtfg
檱	dtfh
棰	dtfk
橅	dtfo
㮑	dtfr
杽	dtg
栍	dth
桻	dthl
株	dtiw
梏	dtj
櫡	dtjn
杵	dtk
棅	dtki
㮔	dtkj
櫄	dtko
㭌	dtl
柞	dtlg
栝	dtm
桖	dtmn
栴	dtmy
楿	dtn
梸	dtng
椱	dtnt
楸	dtow
柉	dtp
櫷	dtpx
㭚	dtq
㭠	dtqg
欑	dtqm
橁	dtqn
㰀	dtqw
権	dtrl
橋	dtsb
桥	dtsr
枖	dtsy
栙	dttj
㯯	dttm
橇	dttt
柊	dtu
㭔	dtuk
櫤	dtun
桘	dtv
櫛	dtvc
枚	dtw
㯚	dtwb
柣	dtwg
㮃	dtxk
柹	dtxt
梅	dtxu
杁	dty
㰏	dtyb
樦	dtyh
楡	dtyx
甫	du
㭣	dub
榈	dubb
櫚	dubb
喸	dubx
棬	duc
郙	duc
乶	ducg
椦	duct
㯗	dud
樽	dudg
楢	dudk
橂	duds
栟	duf
枓	dufg
鄟	dugc
剸	dugn
鷒	dugq
尃	dugy
專	dugy
甎	dugy
样	duh
橍	duh
栏	duhg
栤	duio
様	duio
柈	duj
槎	dujl
欄	duki
橧	dumn
盙	dumn
橺	dun
椫	dunf
椪	dunu
榚	duow
椚	dup
惠	dupu
棁	duq
橌	duq
㮞	duqb
椾	duqn
櫩	duqr
橉	duqt
栨	duqw
鵏	duqx
𬷕	duqx
橷	durq
栚	dusy
檥	duta
㰕	duta
櫊	dutb
槉	duts
橏	duub
檨	duuq
梯	duvt
槏	duw
鿿	duwi
榏	duwm
楼	duxk
樓	duxk
㮶	duxq
櫢	duxt
旉	duyc
樣	duyi
懯	duyp
敷	duyt
杩	dv
榪	dv
㭒	dv
楃	dvaj
櫭	dvak
概	dvaq
椲	dvbt
㮭	dvbu
檘	dvby
杼	dvc
楖	dvc
梮	dvcb
樼	dvcc
㮊	dvd
杻	dvf
椐	dvfb
榐	dvfq
树	dvgy
桪	dvgy
椂	dvh
㯑	dvha
橄	dvht
欘	dvil
棣	dvio
榍	dviq
樨	dvit
㮀	dvix
柽	dvj
樳	dvjg
椵	dvjv
杞	dvk
櫈	dvkm
楑	dvks
橙	dvku
㯸	dvlm
橚	dvlr
楣	dvm
桶	dvmj
㭾	dvmm
杷	dvn
棂	dvow
梞	dvpu
梫	dvpv
根	dvq
楈	dvq
櫲	dvqs
柫	dvr
櫇	dvsw
柕	dvt
梶	dvta
橘	dvtb
桾	dvtb
楙	dvtd
楺	dvtd
壄	dvtj
懋	dvtp
㮘	dvtt
榒	dvuu
柀	dvv
槡	dvvd
橃	dvvm
棳	dvvv
榋	dvvv
橻	dvvv
㯢	dvvw
㭈	dvwg
杛	dvx
柅	dvx
权	dvy
杈	dvy
㮻	dvyl
㭹	dvyx
朳	dw
柗	dwb
㭘	dwb
椧	dwbc
梲	dwbq
検	dwbw
檢	dwbw
枪	dwc
厀	dwc
䣛	dwc
㯓	dwcc
椕	dwcd
桴	dwck
枌	dwco
棌	dwd
榝	dwdm
樧	dwdm
朲	dwg
㭩	dwgy
栓	dwh
桼	dwi
检	dwik
檼	dwjp
桧	dwjx
楥	dwkv
枍	dwkx
棆	dwmf
檜	dwmn
㯒	dwmq
橎	dwn
㓼	dwng
㯶	dwot
柃	dwp
橓	dwpt
榆	dwqn
㯡	dwqv
槄	dwrj
桸	dwsm
㮁	dwsq
梌	dwt
榣	dwtm
櫾	dwtx
㮆	dwuh
檭	dwvq
䴰	dwwa
䴼	dwwa
䴬	dwwa
㭲	dwwb
䴴	dwwb
䴺	dwwb
勑	dwwc
郲	dwwc
麧	dwwc
麪	dwwc
㮝	dwwc
䴸	dwwc
棥	dwwd
麱	dwwd
䴲	dwwd
䴹	dwwd
鬰	dwwe
䴯	dwwe
麯	dwwf
䴽	dwwf
䴵	dwwf
䵂	dwwf
枞	dwwg
來	dwwg
欎	dwwg
欝	dwwg
䵁	dwwg
䴶	dwwh
桽	dwwj
麵	dwwj
㙬	dwwj
㭫	dwwj
䴾	dwwj
櫼	dwwk
蠜	dwwl
賚	dwwm
䵀	dwwm
䴮	dwwm
燓	dwwo
愸	dwwp
憖	dwwp
憗	dwwp
䴳	dwwp
鶆	dwwq
麭	dwwq
麲	dwwq
䙪	dwwq
䚅	dwwq
䳵	dwwq
䴷	dwwq
樊	dwws
猌	dwws
礬	dwws
顂	dwws
䫶	dwws
䴿	dwws
䵆	dwws
攀	dwwt
麥	dwwt
麨	dwwt
麰	dwwt
䴭	dwwt
麴	dwwu
麷	dwwu
䵄	dwwu
麬	dwwv
鐢	dwww
麩	dwww
麳	dwww
㯤	dwww
䵃	dwww
麮	dwwx
麶	dwwx
麫	dwwx
䴱	dwwx
㮬	dwxc
桵	dwxk
棇	dwxp
榽	dwxs
椶	dwxt
松	dwxy
枩	dwxy
梒	dwyb
槍	dwyb
棯	dwyp
枔	dwyv
檎	dwyx
札	dx
朼	dx
枱	dxb
㯞	dxbq
㯿	dxbx
㭓	dxf
㰘	dxkf
㭮	dxkq
朻	dxl
蚻	dxl
樌	dxmw
栺	dxn
椔	dxnb
樔	dxnd
㭇	dxqg
桚	dxqy
檰	dxrm
椽	dxse
椮	dxse
桳	dxsf
㯍	dxsg
梉	dxsj
欚	dxsl
㮥	dxsn
桙	dxtl
栂	dxu
梭	dxwt
枇	dxx
紮	dxx
柪	dxxc
櫟	dxxd
槮	dxxe
梐	dxxj
楷	dxxr
橼	dxxs
櫞	dxxs
槇	dxxw
機	dxxw
檵	dxxx
㭃	dxxy
术	dy
朮	dy
杧	dya
樴	dyat
棓	dyb
槁	dybb
椁	dybc
梈	dybc
槨	dybc
椋	dybi
檩	dybj
檀	dybk
楟	dybk
榱	dybq
欀	dybq
檺	dybs
橔	dybt
檁	dybt
榔	dyc
枋	dyc
櫅	dycr
榳	dyct
榇	dyd
㯎	dyd
櫬	dydq
梓	dyf
樟	dyfg
樜	dyfo
櫎	dyfw
柱	dyh
栐	dyio
桩	dyj
堏	dyj
櫥	dyjg
槠	dyjn
櫧	dyjn
樀	dymf
杭	dymg
柿	dyml
櫰	dymq
橦	dynj
槞	dynx
楴	dypm
怸	dypu
檍	dypu
怷	dypu
榜	dypy
樃	dyq
樈	dyqg
橠	dyqq
㭽	dyqy
㮄	dyqy
㯅	dyrf
椨	dyrg
棭	dyry
楌	dyse
㯆	dyst
檹	dytb
椸	dytc
㯀	dytv
㮵	dyty
柆	dyu
桹	dyv
榶	dyvb
槺	dyvi
槦	dyvl
櫠	dyvm
櫦	dyvt
椩	dyvw
椊	dywf
㰚	dywr
棜	dywu
校	dyww
樆	dywx
樚	dyx
椄	dyxk
橀	dyxm
槒	dyxn
棛	dyxq
梳	dyxr
㯙	dyxt
㯠	dyxt
核	dyxw
很	e
㹽	eaat
獑	eaek
㺂	eakb
犽	eal
狨	eas
㺇	easu
㺝	eatm
狘	eax
㺧	ebbb
㺗	ebbf
玁	ebbt
狆	ebl
㹱	ebll
狷	ebq
犯	ec
㹢	ecb
㹦	ecb
狲	eciw
猛	ecmn
㺟	ecrl
㹶	ectj
狿	ectl
猻	ectx
㺒	ecwe
犼	ecx
狇	ed
猼	edgy
猹	ednk
㺢	edrl
獳	edsm
猍	edww
㹞	eek
狐	eex
狜	efb
玂	efbe
獾	efbr
獖	effm
猉	efh
犴	efl
盾	efm
鶞	efmq
质	efmw
貭	efmw
瞂	efmy
猎	efn
猫	efnb
獏	efns
獚	efnw
獦	efnw
獴	efps
猢	efq
㺃	efqb
獲	efrv
行	eg
㣤	egaa
彻	egac
䡓	egaf
㣝	egas
衐	egav
徊	egbb
徎	egbh
㣬	egbh
彵	egcl
徤	egcv
彶	egcy
㣩	egdd
徆	egdg
徱	egdj
徠	egdw
術	egdy
狾	egek
循	egem
衎	egfl
徝	egfm
徣	egfn
德	egfp
徔	egfp
徳	egfp
憄	egfp
衚	egfq
㣮	egfu
衖	egfw
衠	egfw
㣴	egfw
彺	egh
㣱	eghm
䘘	eghx
衍	egi
徜	egib
彳	egii
愆	egip
㣟	egjb
待	egjg
街	egjj
徍	egjj
衏	egjq
徺	egjs
徒	egjw
衙	egkb
徚	egki
徑	egkj
征	egkl
徢	egkl
徰	egkl
㣔	egkl
㣜	egkn
惩	egkp
徕	egku
鿉	egkv
徙	egll
徏	eglt
㣠	eglu
徟	egmb
衕	egmb
㣚	egmb
徂	egmh
垼	egmj
㠞	egmm
懲	egmp
衢	egmr
忂	egmr
微	egmt
徽	egmt
徵	egmt
徴	egmt
徾	egmt
鰴	egmt
黴	egmt
幑	egmt
㣲	egmt
役	egmv
䘗	egmx
徘	egnf
得	egng
忁	egni
徥	egnl
㣙	egno
㣸	egnt
徧	egpf
徖	egpj
㣷	egpk
㣵	egpu
㣗	egpv
㣘	egqb
䚘	egqm
徇	egqn
衡	egqs
鴴	egqx
鵆	egqx
鸻	egqx
彴	egqy
彽	egqy
㣥	egrg
徨	egrh
㣡	egrl
徼	egrt
徛	egsb
徿	egst
㣕	egsy
㣖	egsy
㣣	egsy
犲	egt
御	egtc
徃	egth
禦	egtj
衝	egtj
㣫	egtj
衘	egtm
䘖	egtm
㣳	egto
復	egtt
㣦	egtx
徉	eguh
従	egul
衜	egur
徶	egut
㣢	egut
径	egvj
律	egvl
躗	egvl
躛	egvl
衞	egvm
䘙	egvm
㦣	egvp
很	egvq
㣯	egvq
彿	egvr
徫	egvt
衛	egvt
徲	egvt
彼	egvv
徦	egvv
讆	egvy
讏	egvy
鿈	egvy
衔	egw
銜	egw
㣛	egwb
聳	egwh
從	egwl
徻	egwn
熧	egwo
彾	egwp
慫	egwp
衑	egwp
㣰	egwp
㣞	egwq
䳷	egwq
徯	egws
徐	egwt
徭	egwt
㹐	egwt
㣭	egwt
㣪	egwv
彸	egwx
㼻	egwy
䵈	egxd
㣨	egxf
衟	egxm
後	egxt
㣧	egxx
彷	egyc
勶	egyc
往	egyh
徸	egyj
㣶	egyk
䘕	egym
㣹	egyp
忀	egyq
徹	egyt
衒	egyx
徬	egyy
狂	eh
猰	ehcs
㺓	ehmw
㤮	ehpu
猜	ehq
鵟	ehqx
𫛭	ehqx
獉	ehtd
獓	ehtw
㺦	ehxx
爪	ei
犭	eiii
彡	eiii
猀	eiit
坕	eij
猟	eimj
㹺	ein
爮	eiqv
㸕	eirv
㹰	eisx
爬	eivn
狤	ejb
猿	ejbq
㹲	ejck
橥	ejd
狋	eji
獟	ejjs
乕	ejml
猪	ejn
狫	ejx
㹤	ejxy
斤	ek
后	ekb
劶	ekbc
郈	ekbc
垕	ekbj
獭	ekbm
獺	ekbm
㹬	ekbw
卮	ekc
邤	ekc
劤	ekct
啠	ekeb
斦	ekek
質	ekem
劕	eken
丘	ekk
邱	ekkc
岳	ekkm
乒	ekkt
兵	ekkw
屔	ekkx
乓	ekky
䖐	eklm
獿	eklt
斶	ekml
犻	ekml
狟	eknk
㹴	eknw
欣	ekqw
颀	eksw
頎	eksw
狭	ekus
㹳	ekvb
巵	ekvn
㹫	ekvw
獮	ekww
㹵	ekxj
㹠	ekxx
斥	eky
䟟	ekyl
㿭	ekyv
独	el
獩	elat
㺣	elka
辵	ell
猇	elmg
虒	elmg
歋	elmq
鷉	elmq
䴘	elmq
䫢	elms
㹿	elnf
獹	elnm
兏	elsx
頿	elxs
㺜	emfs
猠	emfw
狙	emh
狦	emjn
䫇	emjs
狪	emkb
獧	emkq
㹪	emmk
玃	emmv
猾	emp
獨	emql
猡	emqy
獕	emrl
猯	emsm
㹧	emsy
猦	emtl
猧	emvb
狈	emw
狽	emw
玀	emxr
猓	end
猅	enf
猂	enfl
狸	enj
狚	enk
狮	enkm
猥	enkq
獌	enmv
猖	enn
㹨	eno
狎	enp
猬	enq
猲	enqw
猩	enth
獛	enuh
㹭	enxt
猑	enxx
悐	eopu
狣	eoqg
狄	eow
㺠	epee
㺍	epew
狩	epgy
猔	epji
㺚	epju
狞	epkl
獱	epkm
猵	epmf
猽	epnw
獰	eppk
猏	epv
狖	epw
㺙	epxm
㹝	eqag
狗	eqb
㺥	eqby
獬	eqct
㺀	eqep
狝	eqi
覛	eqmq
狥	eqn
㺅	eqst
犰	eqt
㹼	equd
狍	eqv
狰	eqvl
犱	eqy
犳	eqy
㹯	erd
猈	erfg
㺞	erkw
猚	erl
狛	ern
獔	erof
獋	erof
㺘	erow
猊	erqg
㹸	erqg
獡	erqo
獆	ersf
猴	ervt
獀	ervy
獥	eryt
䫠	esbs
狵	ese
澃	esio
狉	esk
猗	eskb
頾	eslx
盨	esmn
獶	esmt
㹮	esn
獂	esri
㺡	estl
犾	esu
獠	esui
獗	esuq
须	esw
須	esw
狹	esww
犹	esx
媭	esxk
嬃	esxk
䇓	esyu
狢	etb
犵	etcg
狏	etcl
狌	eth
狅	etj
獯	etko
㹾	etlb
狧	etm
猘	etmn
猁	etng
獢	etsb
㹣	etu
獅	etvm
㹻	etxk
舟	eu
艦	euam
艥	euba
舯	eubl
郍	euc
䑠	euc
䎇	eucc
䑮	eucd
艋	eucm
舠	euco
䒁	eucr
艇	euct
䑥	eucy
㭧	eud
舾	eudg
猶	eudk
艝	eudv
䑣	eue
舨	euev
䑩	eufb
艓	eufd
䑴	eufh
艜	eufm
䒈	eufm
艨	eufs
艧	eufv
舼	eufw
䑶	euhq
䑭	euij
艡	euin
艄	euiq
艢	eujb
舡	eujl
舸	eukb
艚	eukn
艣	eulc
䑲	eulf
艫	eulm
䑰	eult
舻	eulv
船	eumb
槃	eumd
鞶	eumf
螌	euml
䑺	euml
幋	eumm
艒	eumm
盤	eumm
盘	eumn
舰	eumq
褩	eumq
䑵	eumq
䚀	eumq
磐	eums
搫	eumt
獙	eumt
般	eumv
鎜	eumw
舢	eumx
媻	eumx
縏	eumx
舤	eumy
䑽	eunc
艃	eunj
舳	euno
舺	eunp
䑬	euoq
䑱	eupc
艑	eupf
䑸	eupj
䒄	eupn
䒇	eupn
䑿	eupn
䒃	eupt
㺊	eupu
舮	eupv
䑷	eupv
䑹	eupv
舵	eupx
䑦	euqb
艪	euqn
獜	euqt
鵃	euqx
鸼	euqx
䑼	euqx
艬	euqy
䑧	eurg
艎	eurh
艊	eurm
舶	eurn
艘	eurv
艭	eurv
䑾	eurv
舿	eusx
䑢	eusx
舦	eusy
䑨	eutc
䒀	eutg
艂	euth
艁	eutj
舴	eutl
艞	eutq
舽	eutt
䒉	eutt
舧	euty
艤	euua
䑫	euuf
艖	euuj
艗	euum
䒅	euum
䲍	euuo
艏	euur
䑯	euut
艛	euux
艍	euvf
舥	euvn
艉	euvt
艠	euvu
䑡	euvy
㺌	euw
艙	euwb
䑪	euwb
舱	euwc
艀	euwc
䑳	euwf
獈	euwm
舲	euwp
艌	euwp
艅	euwt
艐	euwt
䑤	euwv
舩	euwx
猐	eux
䒂	euxg
㺏	euxk
舭	euxx
獇	euxx
舫	euyc
䑻	euyc
艟	euyj
航	euym
艈	euyr
艩	euyr
䒆	euyt
艆	euyv
艔	euyv
舣	euyw
舷	euyx
艕	euyy
犸	ev
戶	ev
獁	ev
㐆	evc
殷	evcm
慇	evcp
乺	evec
所	evek
狃	evf
㺛	evf
㺖	evht
㹩	evj
猳	evjv
猤	evks
獼	evkw
猸	evm
峱	evmx
狠	evq
猕	evqi
狒	evr
獝	evtb
猱	evtd
狓	evv
㹟	evwg
狔	evx
反	evy
獫	ewbw
猃	ewik
狯	ewjx
猨	ewkv
獪	ewmn
㺕	ewn
狑	ewp
㺄	ewqn
狶	ewsm
狳	ewt
猞	ewtm
猺	ewtm
㺔	ewto
猙	ewvl
㺤	ewwk
㺋	ewxc
猣	ewxt
獊	ewyb
瓜	ex
獵	exbx
㼌	exex
㺈	exkl
㺐	exnd
㼒	exne
㼉	expq
狁	exqg
瓟	exqv
瓝	exqy
㺁	exrw
猭	exse
瓥	exsl
瓞	extw
㼓	exuw
狻	exwt
狕	exxc
㺑	exxe
狴	exxj
㼖	exxl
㼎	exyw
狺	ey
猄	eybi
獽	eybq
獤	eybt
獐	eyfg
獷	eyfw
㹥	eyh
犿	eylg
犺	eymg
獞	eynj
獍	eyqg
犷	eys
㺆	eysm
鸑	eysq
𬸚	eysq
狱	eysu
獄	eysu
狼	eyv
㺎	eyvl
㹹	eyvw
猝	eywf
狡	eyww
㹡	eyxx
真	f
茝	fa
茞	fa
蔵	faa
载	faaf
載	faaf
臷	faaj
菚	faat
哉	fab
蓲	fabb
䕚	fabm
荿	fac
䓉	fac
苆	faco
䳣	facq
㦲	fact
㢤	fact
栽	fad
酨	fadk
蔪	faek
莗	faf
蓒	fafl
䒰	fah
荎	faj
㘽	faj
㦳	faj
葴	fakb
葳	fakx
芽	fal
蛓	fal
蒧	falb
䵧	famo
蒇	famw
胾	famw
蕆	famw
菿	fang
韯	fank
戴	fanw
烖	faow
苉	faqg
䳒	faqx
截	farl
蕥	farl
䘁	farl
茙	fas
荛	fasx
茂	fat
蘙	fatc
鿀	fatd
藍	fatm
苣	fav
藖	favm
菣	favy
藏	faxa
蘻	faxx
芅	fay
荗	fay
裁	fayq
古	fb
蔮	fbak
茴	fbb
莒	fbb
虈	fbbb
䓵	fbbb
䖀	fbbb
勸	fbbc
鄿	fbbc
酄	fbbc
䕤	fbbc
蘄	fbbe
蕇	fbbf
飌	fbbl
鹳	fbbq
歡	fbbq
觀	fbbq
鸛	fbbq
雚	fbbr
颧	fbbs
顴	fbbs
䕾	fbbt
萼	fbbx
蕚	fbbx
㖛	fbbx
䎁	fbcc
莂	fbcn
㼋	fbex
䓢	fbfb
茵	fbg
蕺	fbha
葺	fbhd
菋	fbji
薗	fbjq
茣	fbks
瓳	fbky
莡	fbll
䕽	fbll
蒉	fblm
蕢	fblm
蕗	fblt
蒷	fbm
莴	fbmw
蒽	fbpu
怘	fbpu
胡	fbq
勀	fbqc
勊	fbqc
兝	fbqc
兙	fbqf
兛	fbqf
克	fbqg
尅	fbqg
兣	fbqj
兡	fbqn
剋	fbqn
兢	fbqq
鹕	fbqq
鶘	fbqq
鶦	fbqq
兞	fbqt
䭌	fbqw
鸪	fbqx
鴣	fbqx
蓶	fbrl
䧸	fbrl
菌	fbtd
䂋	fbtd
䀇	fbtm
故	fbtw
蔨	fbuc
䓃	fbvn
嘏	fbvv
㕝	fbvy
𦭜	fbw
苬	fbwg
莔	fbwm
蒕	fbwm
荶	fbwv
辜	fbyf
节	fc
茄	fcb
苕	fcb
䓧	fcbk
藬	fcbm
莻	fcbx
荔	fccc
茘	fccc
䒳	fcd
菰	fcex
䒖	fcfg
艺	fcg
荪	fciw
𦰡	fcjc
䔖	fcjt
芓	fck
䒒	fck
蔯	fcki
䓝	fcmn
芀	fco
艿	fcp
荫	fcq
藋	fcrl
䔺	fcsq
艻	fct
莛	fctj
莚	fctl
蕯	fctt
蓀	fctx
䔹	fcus
萾	fcvm
蓼	fcwe
䕃	fcwh
蘟	fcwp
蒢	fcwt
蔭	fcwx
芤	fcx
芨	fcy
䔒	fcyb
䕜	fcyf
䔼	fcyl
荵	fcyp
萨	fcys
薩	fcyt
㭉	fd
藲	fdab
莕	fdb
蘦	fdbb
虂	fdbt
䖅	fdbw
菻	fdd
䔁	fdd
菥	fdek
䔯	fdfb
䓩	fdfv
茜	fdg
蒪	fdgy
蓴	fdgy
䔠	fdiq
荰	fdj
䓰	fdj
䕯	fdje
蔈	fdji
蓕	fdjj
蕓	fdjx
薽	fdjy
苯	fdk
莤	fdk
葙	fdm
蕾	fdnb
蕈	fdnf
萙	fdpq
蕙	fdpu
蘎	fdqv
藿	fdrl
蘸	fdro
藮	fdro
䕩	fdsi
薷	fdsm
䖇	fdte
䔦	fdtx
莆	fdu
蓜	fdvk
䕆	fdwn
蕶	fdwp
萊	fdww
菘	fdwx
葽	fdxk
䖆	fdyq
䓄	feek
蓏	feex
荇	feg
葕	fei
蕏	fejn
蓗	fejw
芹	fek
茊	fek
茩	fekb
蓰	fell
䓚	femh
薇	femt
藢	femt
蒰	femv
䓈	femv
䔆	fenj
荻	feow
蘅	feqs
获	fesu
蕦	fesw
莸	fesx
蓹	fetc
蘌	fetj
蕧	fett
蕕	feud
莥	fevf
葎	fevl
蒑	fevm
䓳	fevq
䕔	few
蓯	fewl
蒣	fewt
苽	fex
革	ff
䩽	ffab
苦	ffb
鞇	ffbg
蓳	ffbh
鞓	ffbh
䩰	ffbh
鞼	ffbm
䖄	ffbo
鞙	ffbq
䕿	ffbq
䕼	ffbr
鞀	ffcb
䩯	ffck
䩥	ffcl
勒	ffct
䩠	ffct
鞬	ffcv
靭	ffcy
靱	ffcy
靸	ffcy
靳	ffek
䔮	ffek
龩	ffek
䩝	ffex
鞯	fffc
鞢	fffd
䪇	fffg
䩸	fffh
韊	fffi
鞾	fffj
靬	fffl
鞴	fffm
鞲	fffm
蕡	fffm
䩿	fffm
韉	fffo
䩴	fffq
韄	fffv
鞳	fffw
䪄	fffw
靾	fffx
韈	fffy
䩢	ffge
鞡	ffgy
萁	ffh
䩨	ffha
䩬	ffhj
鞝	ffib
鞺	ffij
鞜	ffin
鞩	ffin
鞘	ffiq
䩖	ffit
苷	ffj
靯	ffj
鞊	ffjb
鞋	ffjj
韇	ffjm
靺	ffkd
䩒	ffkg
䪂	ffki
韁	ffkk
靪	ffkl
䩹	ffku
鞆	ffkw
鞕	ffkw
䩟	ffkw
䩘	ffkx
䩫	ffky
芉	ffl
䩞	fflb
鞐	ffll
䪎	ffmb
靻	ffmh
䪅	ffml
䩤	ffmq
鞅	ffms
䪆	ffmu
䩔	ffmv
蒖	ffmw
靹	ffmw
蘣	ffnh
蘳	ffnj
鞸	ffnj
靼	ffnk
鞮	ffnl
鞰	ffnm
韅	ffno
䩜	ffno
䪁	ffnu
鞨	ffnw
鞉	ffoq
䩵	ffpa
荸	ffpc
葧	ffpc
䩩	ffpc
䩼	ffph
鞚	ffpj
䪋	ffpm
䪀	ffpp
鞑	ffps
䩛	ffpt
韃	ffpu
韆	ffpv
䩳	ffpv
䩪	ffpv
䪈	ffpv
鞍	ffpx
葫	ffq
䩗	ffq
䩕	ffqc
蔕	ffqm
鞔	ffqq
鞠	ffqu
蘜	ffqu
鞄	ffqv
䳬	ffqx
䩓	ffqx
鞫	ffqy
靮	ffqy
韂	ffqy
䩚	ffqy
䪌	ffqy
鞞	ffrf
䕙	ffrl
鞭	ffrw
靴	ffrx
䩭	ffsb
䪊	ffst
䩡	ffsw
靰	ffsx
鞽	fftb
䩐	fftc
鞂	fftd
鞦	ffto
鞒	fftr
萳	ffu
蔷	ffub
鞧	ffud
䪍	ffui
靽	ffuj
鞻	ffux
䩻	ffv
鞣	ffvd
靵	ffvf
䩮	ffvh
靷	ffvl
靶	ffvn
鞎	ffvq
鞁	ffvv
鞃	ffvx
䩑	ffvx
芰	ffvy
靫	ffvy
鞈	ffwb
䩺	ffwc
鞥	ffwf
䩱	ffwn
鞱	ffwr
鞵	ffws
䩣	ffwt
靲	ffwv
鞖	ffwx
葚	ffx
藄	ffx
靿	ffxc
葉	ffxd
䩶	ffxl
蘛	ffxq
鞿	ffxw
䪉	ffxx
䩧	ffy
鞛	ffyb
鞟	ffyc
鞹	ffyc
韀	ffyo
䩾	ffyo
䪃	ffyt
䩲	ffyv
䩙	ffyx
䩷	ffyy
十	fg
䔱	fgbh
賷	fgbm
喪	fgbq
萔	fgcb
協	fgcc
㔹	fgct
博	fgdg
蒱	fgdu
䓆	fgek
卉	fgf
翸	fgfc
枽	fgfd
桒	fgfd
卋	fgfk
贲	fgfm
賁	fgfm
㫩	fgfn
歕	fgfq
䴅	fgfq
尭	fgfs
䫙	fgfs
鼖	fgfv
㔺	fgfx
䥅	fghw
莏	fgit
荴	fgjw
蓵	fgkl
直	fgmh
矗	fgmm
惪	fgmp
㥲	fgmp
㥁	fgmp
鷏	fgmq
颠	fgms
顛	fgms
蘀	fgmu
真	fgmw
㒹	fgmw
嗭	fgmx
戟	fgna
翰	fgnc
乾	fgnc
亁	fgnc
䎐	fgnc
榦	fgnd
斡	fgnf
幹	fgnf
龺	fgnf
韩	fgnj
螒	fgnl
䔶	fgnl
菗	fgno
朝	fgnq
鶾	fgnq
雗	fgnr
韓	fgnt
倝	fgnw
䔾	fgnw
乹	fgnx
畞	fgny
莍	fgoy
勃	fgpc
孛	fgpc
郣	fgpc
愂	fgpp
鹁	fgpq
鵓	fgpq
㪍	fgpt
疐	fgpv
索	fgpx
菢	fgqv
蓷	fgrl
菝	fgsy
葀	fgtm
啬	fgub
丧	fguq
翅	fgvc
攰	fgvc
𨙸	fgvc
攳	fgvg
萚	fgvj
觌	fgvq
鳷	fgvq
䧴	fgvr
卖	fgvs
頍	fgvs
𫠆	fgvs
㲍	fgvt
支	fgvy
协	fgwc
赍	fgwm
賫	fgwm
菈	fgyu
其	fh
苌	fha
萇	fha
蘁	fhbb
㐞	fhcg
葜	fhcs
茸	fhd
棊	fhd
斯	fhek
蟴	fhel
㽄	fhey
藉	fhfn
蕻	fhfw
䓓	fhgy
蘴	fhhu
蔧	fhhv
䔷	fhhv
䒹	fhi
基	fhj
菶	fhjl
蜝	fhl
䒠	fhl
䔜	fhmj
蔶	fhmw
萶	fhn
㫷	fhn
剘	fhng
藕	fhny
惎	fhpu
期	fhq
菁	fhq
朞	fhq
欺	fhqw
䳢	fhqx
碁	fhs
䫏	fhsw
㲨	fhta
蓁	fhtd
蔜	fhtw
㪸	fhuf
䔊	fhuf
藂	fhvi
蕼	fhvl
菆	fhvy
甚	fhx
綦	fhx
戡	fhxa
勘	fhxc
斟	fhxf
卙	fhxf
夦	fhxq
歁	fhxq
㽎	fhxq
䫖	fhxs
尠	fhxt
䓯	fhxu
㪛	fhxv
諅	fhy
蘵	fhya
䔐	fiaa
蕖	fiad
蘫	fiam
菃	fiav
藻	fibd
薀	fibm
范	fic
菬	ficb
荡	fice
莯	fid
藫	fidf
薄	fidg
薸	fidj
蒲	fidu
䓷	fieg
䓅	fiek
蒎	fieq
葓	fifw
蔳	fihq
艹	fiii
廾	fiii
卄	fiii
卌	fiii
莎	fiit
䓾	fiix
茳	fijl
蔆	fijt
菏	fikb
䓑	fikf
萍	fiku
鿊	fill
蔋	filv
菹	fimh
䕪	fimu
莈	fimv
䓠	fin
蕩	fine
蕰	finm
蘯	finm
䕕	finv
䔽	finw
蕅	finy
莐	fipq
莦	fiq
䓋	fiqa
蒅	fiqd
萷	fiqn
萢	fiqv
䓜	fiqy
萡	firn
蒞	firy
茪	fisx
䒚	fit
落	fitb
萿	fitm
蓱	fiuf
葏	fivl
菠	fivv
蓡	fivv
薓	fivv
蔢	fivx
䒕	fiw
虃	fiwk
藩	fiwn
蕍	fiwn
蒤	fiwt
菭	fixb
薻	fixd
茫	fiya
薃	fiyb
蓅	fiyr
蒗	fiyv
甘	fj
芏	fj
䓀	fjb
薹	fjba
䕒	fjbb
䕵	fjbq
薣	fjbv
苇	fjc
邯	fjc
䓔	fjck
某	fjd
㽑	fjdf
䓁	fjgy
䒬	fji
苿	fjiw
茥	fjj
葑	fjjg
蒜	fjji
䕀	fjjq
蕘	fjjs
㽍	fjky
䗣	fjll
斠	fjmf
冓	fjmj
藚	fjmm
觏	fjmq
覯	fjmq
顜	fjms
䔈	fjmw
蒆	fjmx
茿	fjmy
著	fjn
䑓	fjpa
䓌	fjpu
芫	fjqg
荺	fjqu
莰	fjqw
䲺	fjqx
羐	fjqy
甛	fjtm
䕮	fjuu
蕔	fjuv
㽐	fjuw
蓻	fjuy
薵	fjvg
薔	fjwb
芙	fjwg
爇	fjwo
䕭	fjwo
䓇	fjwr
菱	fjwt
莁	fjww
藝	fjwx
蓺	fjwy
芌	fjx
荖	fjx
蓋	fjxm
蓍	fjxn
芸	fjxy
䒧	fjxy
䕋	fjyb
蘾	fjyq
廿	fk
苛	fkb
囏	fkbb
䔅	fkbb
勤	fkbc
鄞	fkbc
斳	fkbe
堇	fkbh
菫	fkbh
藾	fkbm
葍	fkbn
䓶	fkbn
㸐	fkbo
懃	fkbp
戁	fkbp
觐	fkbq
蔌	fkbq
歎	fkbq
歏	fkbq
虉	fkbq
覲	fkbq
𬟁	fkbq
難	fkbr
䕱	fkbs
䔩	fkbt
㝻	fkbt
荳	fkbu
蒚	fkbu
艱	fkbv
臡	fkbw
㔮	fkbx
茉	fkd
茾	fkf
華	fkfj
荆	fkfn
荊	fkfn
鷨	fkfq
芋	fkg
丗	fkii
龷	fkii
黃	fkkw
艼	fkl
芐	fklg
蔫	fklo
蘷	fklt
虁	fklt
蕀	fkmi
茦	fkmi
萰	fkmi
芾	fkml
䒥	fkml
莿	fkmn
蓸	fkmn
颟	fkms
顢	fkms
蓛	fkmt
苪	fkmw
𬜯	fkmw
㒼	fkmy
䓣	fkmy
䕻	fkmy
昔	fkn
黇	fknb
䵍	fknc
斮	fkne
薚	fkne
䵏	fkne
斢	fknf
䵐	fknf
茢	fkng
黈	fknh
菄	fkni
黊	fknj
薤	fknk
荁	fknk
薑	fknk
剒	fknn
鹊	fknq
鵲	fknq
鷬	fknq
黆	fknq
䵋	fknq
䧿	fknr
䵎	fkns
㪚	fknt
黅	fknv
皵	fknv
黄	fknw
莄	fknw
䵌	fknw
炗	fkow
帯	fkpm
䠠	fkql
帶	fkqm
慸	fkqp
散	fkqt
菾	fksi
芜	fksx
酀	fkuc
莱	fkud
苹	fkuk
㬫	fkun
燕	fkuo
㷼	fkuo
鷰	fkuq
䴏	fkuq
荚	fkus
嬊	fkux
䓊	fkvb
萐	fkvl
荑	fkvw
萋	fkvx
共	fkw
輂	fkwa
䢼	fkwc
㭟	fkwd
恭	fkwi
㳟	fkwi
蕐	fkwj
蛬	fkwl
䳍	fkwq
拲	fkwt
巷	fkwv
薞	fkwv
䢽	fkwv
薾	fkww
世	fkx
䒓	fkx
勚	fkxc
勩	fkxc
葝	fkxc
枼	fkxd
葬	fkxf
塟	fkxj
莖	fkxj
贳	fkxm
貰	fkxm
萅	fkxn
㰥	fkxq
芚	fkxx
干	fl
茧	fl
薉	flat
苫	flb
蓾	flbo
邗	flc
䶬	flfs
麉	flfy
蘋	flis
𬞟	flis
荹	flit
䒙	flk
茮	flki
菽	flkv
芷	fll
蘃	flld
蕋	flll
萀	flmg
蔖	flmh
㿻	flmn
䓬	flnf
刊	flng
蘆	flnm
藘	flnp
覝	floq
㶣	flow
薒	flqu
鳱	flqx
䧲	flrl
䕫	flrt
顸	flsw
頇	flsw
虄	fltt
攼	fltw
茈	flx
䓱	flxd
䔝	flxx
苜	fm
蔑	fmay
苘	fmb
莇	fmct
萛	fmf
䒼	fmfk
蕽	fmfs
䓦	fmfw
芁	fmg
苴	fmh
苒	fmj
苚	fmj
䓟	fmjb
䕸	fmjb
䒣	fmjg
萺	fmjm
薯	fmjn
䕉	fmju
䔴	fmjv
茼	fmkb
䕎	fmkn
䔇	fmku
芇	fml
萜	fmlb
茁	fmm
蕒	fmmw
蘡	fmmx
荝	fmng
萴	fmng
蓇	fmp
薎	fmpa
鄸	fmpc
䠢	fmpl
瞢	fmpm
夢	fmpq
顭	fmps
蘉	fmpv
䒐	fmpv
薨	fmpx
甍	fmpy
苋	fmqg
莧	fmqg
薥	fmql
萝	fmqy
萈	fmqy
䣐	fmsc
蘮	fmsn
鶧	fmsq
䚆	fmsq
㲟	fmst
鿦	fmst
繤	fmsx
英	fmsy
葻	fmtl
蔝	fmud
菵	fmuy
芟	fmv
萵	fmvb
䒻	fmvk
藈	fmvs
芮	fmwg
䒽	fmww
萞	fmwx
繭	fmxl
蘿	fmxr
薡	fmxv
藣	fmxx
芃	fmy
䒟	fmy
藅	fmyn
䕧	fmyw
䒤	fn
苗	fnb
莮	fnct
菒	fnd
菓	fnd
䕁	fnd
菲	fnf
草	fnfg
蓽	fnfj
䓍	fnfl
䔬	fnfw
莳	fngy
蕞	fnhv
荲	fnj
蒔	fnjg
韮	fnk
葨	fnkq
勱	fnmc
蠆	fnml
躉	fnml
䘍	fnml
蒀	fnmn
䖁	fnmp
蔓	fnmv
萬	fnmy
菖	fnn
蘽	fnnd
㔈	fnng
蘲	fnnj
蕌	fnnn
藟	fnnn
虆	fnnx
苖	fno
葸	fnpu
蕜	fnpu
萌	fnq
䓪	fnqe
葛	fnqw
鹋	fnqx
鶓	fnqx
募	fnsc
鄚	fnsc
慕	fnsi
墓	fnsj
㱳	fnsk
蟇	fnsl
幕	fnsm
暮	fnsn
摹	fnst
蓦	fnsv
驀	fnsv
莫	fnsy
謩	fnsy
葃	fntl
蓝	fntm
薱	fnug
䕺	fnuv
茰	fnwy
蔂	fnx
䒶	fnxt
菎	fnxx
蔊	fonf
藀	fooo
菼	foow
䓎	foqy
薬	ford
薠	fosw
苂	fow
䕰	fown
蕿	fowv
蘹	foyq
芝	fp
莲	fpaf
荤	fpaf
葷	fpaf
蓮	fpaf
营	fpbb
蔰	fpbv
茕	fpcf
茡	fpck
劳	fpct
䓖	fpct
䕖	fpcx
荣	fpd
蒏	fpdk
蒁	fpdy
菦	fpek
藆	fpft
萣	fpg
藼	fphp
莹	fphy
荥	fpio
茔	fpj
蒄	fpjg
萗	fpji
莞	fpjq
薳	fpjq
鸏	fpjq
鹲	fpjq
䓕	fpjq
蒙	fpjs
氋	fpjt
蔲	fpjt
薘	fpju
蔻	fpjv
䓻	fpjx
苎	fpk
荢	fpkg
䔎	fpki
萱	fpkk
苧	fpkl
薲	fpkm
䕐	fpkn
䔰	fpkn
藗	fpkq
蔩	fpkw
萤	fpl
蘧	fpls
薖	fpmb
萹	fpmf
萓	fpmh
䔃	fpmh
带	fpml
䒮	fpmy
蓂	fpnw
䕣	fpnw
荧	fpow
蘂	fppd
薴	fppk
藌	fppl
蔤	fppm
䔭	fppm
蕊	fppp
䒿	fpq
菀	fpqc
䒞	fpqg
䕓	fpqj
莺	fpqx
蒬	fpqy
䒯	fpqy
蒮	fprl
蓿	fprn
藛	fpro
藭	fprv
菪	fps
蓫	fpse
藔	fpsi
葖	fpsu
䓞	fpsu
荙	fpsy
苾	fpt
蓬	fpth
䔏	fptj
荦	fptl
䓨	fptm
芯	fpu
蒾	fpud
䔗	fpuh
芦	fpv
菅	fpv
菺	fpv
蓪	fpvm
蕸	fpvv
蓥	fpw
茓	fpw
蓉	fpwb
萦	fpx
荌	fpxk
䕂	fpxq
藡	fpyf
䔂	fpyf
芪	fqag
茋	fqay
苟	fqb
茗	fqb
葂	fqbc
莬	fqbq
菟	fqby
苑	fqc
茒	fqc
䒢	fqc
蒥	fqcn
藰	fqcn
葾	fqcp
荕	fqct
薢	fqct
菔	fqcv
葡	fqdu
䔕	fqdu
芴	fqe
葱	fqep
䓤	fqep
茐	fqey
蔡	fqji
茚	fqkc
蓟	fqkn
蔔	fqkn
藓	fqku
藑	fqmt
萯	fqmw
荀	fqn
䓒	fqnb
葪	fqng
﨟	fqnw
薊	fqon
蘇	fqot
蘚	fqou
䔡	fqow
萠	fqq
葋	fqqb
蒯	fqqn
茤	fqqy
萏	fqrj
蔸	fqrq
䔳	fqso
薝	fqsy
艽	fqt
茆	fqtc
檠	fqtd
㢣	fqtf
荈	fqtj
葄	fqtl
蟼	fqtl
萄	fqtm
憼	fqtp
擎	fqtt
驚	fqtv
敬	fqtw
警	fqty
蕂	fquc
菊	fqud
蔛	fquf
藤	fqui
虅	fquv
䕨	fqux
苞	fqv
萉	fqvn
芡	fqw
蕵	fqwv
茑	fqx
蔦	fqx
蒭	fqxx
芶	fqxy
芍	fqy
芄	fqy
芕	fqy
茷	frat
䒫	fray
蒐	frb
葆	frbd
茽	frbl
藵	frbq
芿	frcp
㗡	frcx
茠	frd
䔌	frdk
䕈	frfd
萆	frfg
苻	frgy
葟	frh
葮	frhm
蒨	frhq
葲	frio
茌	frj
芢	frjg
龿	frjj
荷	frkb
藇	frkw
萑	frl
蓧	frld
蓚	frle
蓨	frlq
莜	frlt
虋	frmc
䕟	frmw
苮	frmx
苩	frn
䕗	frnr
蕉	frow
蒠	frpu
萖	frqg
蕮	frqo
莵	frqy
菂	frqy
舊	frrj
藠	frrr
䔤	frsn
茯	frsu
荏	frtj
莋	frtl
蔥	frtp
䔀	frtx
䓲	fruq
薁	frus
葩	frvn
劐	frvn
葔	frvt
葠	frvv
蒦	frvy
蓃	frvy
萸	frwg
蘤	frwo
蓖	frwx
花	frx
葰	frxt
蒊	frxx
蓓	fryb
薂	fryt
莅	fryu
若	fsb
䓏	fsb
䖃	fsbb
鄀	fsbc
蠚	fsbl
惹	fsbp
苊	fsc
苈	fsct
莽	fsf
莾	fsff
䒎	fsfv
蓐	fsgy
莀	fsj
萘	fsji
藸	fsjn
荂	fsjx
苤	fsk
䓫	fskb
䓐	fskx
芣	fsl
荐	fslc
茬	fslj
荋	fsm
菴	fsnx
䒴	fsq
䔚	fsq
蒝	fsri
藞	fsss
䔸	fsss
䓴	fssy
茏	fst
蘢	fst
蕤	fsth
藶	fstl
䕢	fsuj
蕨	fsuq
茇	fsvy
苃	fsvy
鿒	fsw
鿓	fsw
莢	fsww
䔪	fsww
芖	fsy
葢	fsym
芼	fta
莪	ftat
茖	ftb
萂	ftb
䓡	ftb
萭	ftby
芞	ftc
䒗	ftcg
莠	ftcp
䒩	ftd
芊	ftfg
菙	ftfk
蕪	ftfo
䓙	ftfu
苼	fth
莑	fthl
蕱	ftiq
茱	ftiw
薐	ftjt
蘍	ftkc
董	ftkj
薰	ftko
薫	ftko
䒜	ftl
䓘	ftlb
苲	ftlg
䒷	ftm
蒩	ftmh
䔘	ftmh
䒸	ftmn
蘈	ftms
萫	ftn
䔧	ftnd
莉	ftng
䔣	ftnt
藒	ftnw
萩	ftow
䒦	ftp
藊	ftpf
蔾	ftqd
蘓	ftqo
䔟	ftqq
菞	ftqt
藜	ftqw
蘒	ftqx
萟	ftqy
薭	ftrf
薙	ftrl
䕌	ftrl
䕴	ftro
䒨	fts
蕎	ftsb
荞	ftsr
芺	ftsy
䔉	fttd
蘒	fttp
苳	ftu
萪	ftuf
苸	ftuk
蕛	ftut
孽	ftvc
㔑	ftvc
蘖	ftvd
躠	ftvl
蒒	ftvm
蘬	ftvm
糵	ftvu
蒛	ftvw
㜸	ftvx
薛	ftvy
䒘	ftw
苵	ftwg
䕝	ftwm
萎	ftxk
蘶	ftxr
莓	ftxu
蘩	ftxx
南	fu
蔄	fub
𬜬	fub
䕡	fubb
菤	fuc
𫇭	fucy
䔵	fud
䔿	fudg
荓	fuf
荘	fuj
蒫	fujl
蓤	fujt
蘭	fuki
虌	fump
蔽	fumt
蕳	fun
蕲	fune
蓔	fuow
菛	fup
蕄	fupu
莌	fuq
蕑	fuq
蒋	fuqg
薋	fuqm
葥	fuqn
茨	fuqw
藱	furb
蔺	furl
藺	furl
蘱	fuss
献	fusu
䓺	fusy
䕏	futa
蒺	futs
蒍	fuvo
蒹	fuw
苝	fux
蒌	fuxk
葁	fuxk
蔅	fuxk
蔞	fuxk
蒴	fuxq
薮	fuxt
藪	fuxt
䕞	fuyv
苢	fv
䔍	fv
苠	fvag
蔇	fvaq
蘗	fvbd
蔃	fvbl
葦	fvbt
䓿	fvbu
薜	fvby
芧	fvc
莭	fvc
虇	fvfr
荨	fvgy
䒭	fvgy
菉	fvh
葞	fvhd
䒱	fvik
䕄	fvim
蒸	fvio
萧	fvir
菡	fvix
茎	fvj
蔚	fvjg
蕁	fvjg
藯	fvjp
葭	fvjv
芑	fvk
䕬	fvkk
葵	fvks
䔲	fvku
䕳	fvkw
茟	fvl
䒡	fvl
䔫	fvli
藎	fvlm
蔬	fvlr
蕭	fvlr
苐	fvlt
葿	fvm
䓛	fvmm
芭	fvn
菷	fvpm
茛	fvq
茀	fvr
蓣	fvsw
蕷	fvsw
茅	fvt
芛	fvt
荱	fvta
莙	fvtb
蓩	fvtc
葇	fvtd
蔒	fvto
鶜	fvtq
䓮	fvtt
䔥	fvur
荬	fvus
蒻	fvuu
蕟	fvvm
芵	fvwg
芎	fvx
苨	fvx
苰	fvxy
芆	fvy
荩	fvyu
菳	fw
䒔	fw
荅	fwb
蘥	fwbf
蘝	fwbq
蘞	fwbt
薟	fwbw
苍	fwc
棻	fwcd
莩	fwck
葐	fwcm
芬	fwco
苏	fwct
菜	fwd
蔱	fwdm
䓭	fwdn
葊	fwf
荃	fwh
莶	fwik
蔹	fwit
苶	fwiw
荟	fwjx
萲	fwkv
菕	fwmf
薈	fwmn
蕃	fwn
剳	fwng
苅	fwng
薶	fwnj
苓	fwp
蕣	fwpt
薆	fwpt
萮	fwqn
鴱	fwqx
鷋	fwqx
䔙	fwqy
芥	fwr
蓞	fwrj
藐	fwrq
莃	fwsm
䕘	fwsw
茶	fwt
荼	fwt
䔄	fwtm
蔿	fwto
蘨	fwtx
䔑	fwuf
䓹	fwv
薍	fwvx
苁	fwwg
莝	fwwj
葅	fwwm
蓌	fwwt
䕥	fwww
䔢	fwwx
䒝	fwwy
芲	fwx
蓊	fwxc
荽	fwxk
䓗	fwxp
蒵	fwxs
葼	fwxt
艾	fwy
莟	fwyb
蒼	fwyb
菍	fwyp
芩	fwyv
䒺	fx
茹	fxb
苔	fxb
葈	fxbd
蘊	fxbm
蒘	fxbt
蕠	fxbx
䒵	fxck
䒪	fxf
菇	fxfb
荮	fxgy
葤	fxgy
䔋	fxit
荭	fxjl
葒	fxjl
蘏	fxjs
葘	fxkn
莼	fxkx
蒓	fxkx
蒳	fxmw
菑	fxnb
蕴	fxnm
藴	fxnm
蘰	fxnv
蘕	fxph
蕝	fxqv
药	fxqy
葯	fxqy
䔨	fxrl
䕅	fxrv
蘠	fxsb
蒃	fxse
䓼	fxse
薅	fxsg
蔣	fxsg
莊	fxsj
䔛	fxsw
芗	fxt
䒲	fxta
蘔	fxts
蔠	fxtu
薿	fxtv
荍	fxtw
苺	fxu
蒶	fxwc
荾	fxwt
藧	fxwv
䕑	fxwx
芘	fxx
蕬	fxx
孶	fxxc
苭	fxxc
䒛	fxxc
藥	fxxd
蔘	fxxe
荜	fxxf
䓸	fxxf
蒈	fxxr
茲	fxxx
葌	fxxx
薌	fxyc
虊	fxyd
䖂	fxyt
苡	fxyw
䓂	fy
芒	fya
菩	fyb
蒿	fybb
蔀	fybc
藁	fybd
葶	fybk
䕊	fybk
蓑	fybq
藃	fybq
蘘	fybq
藳	fybt
䔻	fybt
薧	fybx
䕦	fyby
芳	fyc
蓈	fyc
虀	fyck
薺	fycr
蔴	fydd
薪	fyde
蘼	fydn
藽	fydq
蘑	fyds
藦	fydt
䕷	fydx
莘	fyf
蔁	fyfg
蓆	fyfm
蔗	fyfo
芠	fyg
薼	fyj
藷	fyjn
薦	fyko
苄	fylg
蔏	fymb
蔐	fymf
苀	fymg
蔎	fymv
萻	fyn
蕫	fynj
蔼	fynw
藹	fynw
䔞	fyof
藨	fyow
蒂	fypm
薏	fypu
莣	fypu
蒡	fypy
蓢	fyq
䒾	fyq
蒟	fyqb
䕍	fyqb
䔔	fyqg
菧	fyqy
荒	fyr
荠	fyr
萕	fyr
䕇	fyrb
䕶	fyrv
㼹	fyry
藙	fysm
䕛	fysw
蓭	fysx
葹	fytc
䔓	fytk
蔟	fytt
蔙	fytv
苙	fyu
蘪	fyud
薕	fyuw
莨	fyv
蓎	fyvb
䓽	fyvk
䕠	fyvm
菮	fyvw
萃	fywf
蓙	fywj
萒	fywq
蓘	fywq
蔉	fywq
蘺	fywr
䕹	fywr
菸	fywu
蘐	fywv
茭	fyww
蓠	fywx
蔍	fyx
菨	fyxk
蓄	fyxn
茺	fyxq
蕹	fyxr
荄	fyxw
䕲	fyyj
拆	g
挋	ga
摳	gabb
掝	gabk
捓	gac
摲	gaek
捙	gaf
搟	gafl
擓	gair
拣	gaiw
挃	gaj
拭	gajl
㨔	gakb
搣	gako
撼	gakp
揻	gakx
㧎	gal
摵	gali
㧜	gaml
捯	gang
揠	ganx
撍	gaqn
㨤	garl
挠	gasx
找	gat
㧔	gat
㩜	gatm
攬	gatq
㨖	gatw
拒	gav
摼	gavj
抠	gawy
扣	gb
摑	gbak
捛	gbb
操	gbbd
撣	gbbf
捌	gbcn
拐	gbct
捆	gbd
㩛	gbdg
㧽	gbfb
㧢	gbg
挰	gbh
擑	gbha
揖	gbhd
掴	gbhy
捉	gbll
撌	gblm
损	gbm
損	gbm
攌	gbmq
摁	gbpu
捐	gbq
拀	gbqg
㨡	gbse
挹	gbvn
抧	gbw
搵	gbwm
招	gcb
拁	gcb
挧	gcc
拹	gccc
搚	gccq
挅	gcd
扬	gce
扟	gcfg
挪	gcjc
扡	gcl
掹	gcmn
㧅	gco
扔	gcp
㩣	gcpa
擢	gcrl
摺	gcrn
撱	gcsq
扐	gct
挺	gctj
挻	gctl
搎	gctx
揵	gcvl
㨕	gcvm
报	gcvy
摎	gcwe
扨	gcy
扱	gcy
搮	gdd
㨆	gdd
㩒	gddj
拪	gdg
搏	gdgy
摶	gdgy
摽	gdji
摴	gdjx
擂	gdnb
撢	gdnf
揸	gdnk
攉	gdrl
擩	gdsm
捕	gdu
㩕	gdwp
㩤	gdyt
哲	geb
踅	gebl
乴	gecg
梊	ged
㩫	geem
揗	gefm
抓	gei
埑	gej
折	gek
拞	gek
㧨	gekb
捳	gekm
捠	gekw
蜇	gel
搋	gelm
擨	gelq
䀸	gem
搬	gemv
晢	gen
烲	geow
焎	geow
悊	gepu
挀	geq
掀	geqw
硩	ges
㿱	gevv
鋬	gevw
扳	gevy
銴	gew
摐	gewl
䭁	gewv
㧓	gex
䋢	gex
娎	gexk
誓	gey
拆	gey
裚	geyq
㩰	gfbd
㨷	gfbh
擹	gfbq
攤	gfbr
㩲	gfbr
撕	gfek
擛	gffd
掑	gfh
搑	gfhd
拑	gfj
擆	gfjn
撶	gfkj
扞	gfl
㨁	gfmh
搆	gfmj
攧	gfms
搷	gfmw
㨅	gfmw
㨺	gfmy
㩢	gfmy
措	gfn
撠	gfna
描	gfnb
㨴	gfnc
擀	gfnf
㩥	gfnk
摸	gfns
撗	gfnw
擖	gfnw
捞	gfpc
挬	gfpc
㨲	gfpd
㩚	gfps
攃	gfqj
摕	gfqm
㨚	gfqn
撒	gfqt
擏	gfqt
擮	gfrl
擭	gfrv
掿	gfsb
擜	gfsu
揇	gfu
技	gfvy
拱	gfw
搭	gfwb
搽	gfwt
抴	gfx
揕	gfx
揲	gfxd
捄	ggoy
抂	gh
掁	gha
揶	ghc
挷	ghc
揳	ghcs
挕	ghd
挵	ghf
攝	ghhh
㩨	ghhp
㨹	ghhv
捧	ghjl
揍	ghks
摂	gho
掅	ghq
㧼	ghq
摏	ghrj
搸	ghtd
摄	ghvv
掫	ghvy
㨞	ghx
㧟	gia
撐	gial
扌	giii
挱	giit
摚	gij
攩	gimo
㧺	gin
擋	ginb
搅	gipq
撹	gipq
捎	giq
挄	gisx
抄	git
挘	gitc
撑	gitg
㨘	gitm
毮	gitt
挡	givh
扗	gj
拮	gjb
擡	gjba
㨬	gjbq
撷	gjbs
擷	gjbs
持	gjgy
抺	gjiw
挂	gjj
掛	gjjl
撓	gjjs
拷	gjkx
扛	gjl
摃	gjmw
㨋	gjn
撎	gjpu
抏	gjqg
抟	gjv
擣	gjvg
撵	gjwa
攆	gjwa
扶	gjwg
攅	gjwm
摫	gjwq
捇	gjwr
掕	gjwt
扝	gjx
㧯	gjx
搕	gjxm
搘	gjxn
抎	gjxy
抾	gjxy
抲	gkb
捒	gkbi
攋	gkbm
揊	gkbn
揦	gkbn
㨽	gkbn
攮	gkbq
摗	gkbq
搹	gkbu
抹	gkd
扜	gkg
拝	gkhl
打	gkl
拺	gkmi
揀	gkmi
㧊	gkml
抦	gkmw
掚	gkmy
攦	gkmy
挒	gkng
㨂	gkni
㩖	gknk
搢	gknn
㩅	gknn
挜	gknu
掗	gknu
挭	gknw
㧷	gksb
掭	gksi
㩑	gksn
抚	gksx
抨	gkuk
挟	gkus
捂	gkvb
捷	gkvl
挗	gkvw
捿	gkvx
擟	gkww
扙	gkwy
挳	gkxj
扽	gkxx
㧚	gkxy
拈	glb
掳	glct
扑	glg
捗	glit
挊	gljl
拤	glkl
㩵	glks
掓	glkv
扯	gll
摣	glmh
揁	glmw
㩬	glna
擄	glnc
掉	glnf
攎	glnm
攄	glnp
摅	glpu
掯	glq
㩀	glqy
據	glse
㨿	gltm
摢	gltu
㨗	glvl
㧗	glx
㨜	glyg
㧏	gm
挆	gmd
擃	gmfs
捵	gmfw
抯	gmh
拥	gmj
抩	gmj
㨄	gmjb
擇	gmju
摆	gmjx
㧇	gmk
挏	gmkb
㧩	gmkm
擐	gmkq
㨟	gmku
㧆	gml
拙	gmm
㩴	gmmr
攫	gmmv
撄	gmmx
攖	gmmx
㩄	gmnp
㩏	gmo
搰	gmp
挸	gmqg
擉	gmql
攜	gmrb
㩗	gmrc
摧	gmrl
揣	gmsm
㨏	gmso
抰	gmsy
掆	gmum
投	gmv
抐	gmwg
攞	gmxr
擺	gmxx
抇	gn
搨	gncc
捰	gnd
排	gnf
㩧	gnfi
捍	gnfl
撮	gnhv
㨪	gnis
捏	gnj
捚	gnj
担	gnk
揚	gnke
㧹	gnkg
提	gnkl
揋	gnkq
抻	gnl
捜	gnlv
揾	gnmn
摱	gnmv
㩸	gnnk
㩹	gnnm
攂	gnnn
抽	gno
押	gnp
揌	gnpu
掦	gnqe
擝	gnqm
㩎	gnqs
揭	gnqw
掲	gnqx
撂	gntb
㨫	gntm
揽	gntq
撲	gnuh
擈	gnuh
摞	gnx
拽	gnxt
掍	gnxx
捑	gnxy
撔	gnyi
揯	gokk
搄	gokk
攚	goob
撈	gooc
㩞	good
掞	goow
挑	goqg
求	goy
䣇	goyc
盚	goym
慦	goyp
裘	goyq
㐜	goyq
救	goyt
皳	goyv
䥭	goyw
挥	gpaf
揮	gpaf
摙	gpaf
撺	gpbl
㨭	gpbv
搧	gpcc
挖	gpcg
㧖	gpcg
㧲	gpd
攨	gpee
摈	gpew
搲	gpex
㩟	gpfd
㩙	gpfj
攓	gpfl
攐	gpfq
㩃	gpfu
㩷	gpfv
掟	gpg
挝	gpgy
搳	gphb
攇	gphp
控	gpjl
捖	gpjq
撻	gpju
揎	gpkk
拧	gpkl
擯	gpkm
撾	gpmb
揙	gpmf
抭	gpmg
㨠	gpnw
擰	gppk
㨸	gppm
捥	gpqc
抌	gpqg
擦	gpqj
搉	gprl
㩁	gprl
摍	gprn
攛	gprx
㨳	gpsb
捩	gpsu
揬	gpsu
挞	gpsy
㧙	gpt
挓	gpta
揢	gptb
摓	gpth
搾	gptl
㨓	gptl
搥	gptv
抋	gpu
护	gpv
掮	gpv
捾	gpv
㩈	gpvb
㧒	gpw
搈	gpwb
探	gpwd
摉	gpwq
拕	gpx
按	gpxk
擿	gpyf
抈	gq
扺	gqag
捪	gqan
抵	gqay
拘	gqb
挽	gqbq
搀	gqbu
攙	gqby
抑	gqc
㐝	gqcg
㨨	gqcn
抛	gqct
揔	gqep
㧾	gqep
㧰	gqiw
摖	gqji
撸	gqkn
捔	gqm
换	gqms
換	gqms
捣	gqmx
搗	gqmx
㧦	gqn
摀	gqo
擼	gqon
掤	gqq
拸	gqqy
掐	gqrj
㨮	gqrq
㧪	gqsc
撚	gqso
擔	gqsy
扏	gqt
㧕	gqtc
搩	gqtd
掏	gqtm
搖	gqtm
抣	gqu
掬	gqud
㩂	gquf
抱	gqv
挣	gqvl
扻	gqw
㨶	gqx
搊	gqxx
抅	gqxy
执	gqy
扚	gqy
揈	gqy
㨱	gqy
势	gqyc
垫	gqyj
蛰	gqyl
贽	gqym
热	gqyo
鸷	gqyq
挚	gqyt
絷	gqyx
㨐	grbd
携	grcp
捭	grfg
㔼	grfg
拊	grgy
揘	grh
㧶	grh
㧮	grj
揑	grjl
攑	grkj
㩮	grkt
推	grl
擕	grlc
㩦	grmb
拍	grn
擤	grnr
撨	grow
掜	grqg
㩳	grrv
搝	grsu
拰	grtj
摠	grtp
擙	grus
扸	grv
搜	grvy
㨦	grvy
㩭	grwc
攪	grwq
撽	gryt
拓	gs
㧵	gsb
扼	gsc
拋	gsct
㧻	gse
捹	gsff
搙	gsgy
揼	gsio
振	gsj
摦	gsje
捺	gsji
捱	gsjj
㨒	gsjj
撦	gsjn
㨊	gsjq
挎	gsjx
抷	gsk
掎	gskb
抔	gsl
拵	gslc
㧫	gsm
抪	gsml
擾	gsmt
擫	gsns
掩	gsnx
拻	gsow
䳲	gsqx
㩡	gsss
㨎	gssy
拢	gst
攏	gst
攊	gstl
㧋	gsu
撩	gsui
撅	gsuq
拔	gsvy
抜	gsvy
挾	gsww
摤	gsww
扰	gsx
扤	gsx
才	gt
㧌	gta
托	gtag
扥	gtag
㧴	gtat
挌	gtb
㧉	gtc
扢	gtcg
拖	gtcl
抍	gtf
扦	gtfg
捶	gtfk
撫	gtfo
插	gtfr
揷	gtfr
抙	gtg
捀	gthl
㧣	gtiw
捁	gtj
㩐	gtjg
㩍	gtki
㨀	gtki
揰	gtkj
挿	gtkl
㩶	gtkw
拃	gtlg
揝	gtln
括	gtm
拠	gtmg
鼒	gtmv
攥	gtmx
摥	gtne
揪	gtow
抸	gtp
㧥	gtqg
攒	gtqm
攢	gtqm
撟	gtsb
挢	gtsr
㧞	gtsv
擌	gtsw
扷	gtsy
撬	gttt
擶	gtun
擳	gtvc
撘	gtwb
抶	gtwg
捼	gtxk
挴	gtxu
㩯	gtxx
扖	gty
搃	gubp
捲	guc
㧑	gucy
擲	gudc
撙	gudg
揂	gudk
拼	guf
抖	gufg
撋	guh
拦	guhg
拌	guj
搓	gujl
攔	guki
撯	gum
撇	gumt
掸	gunf
掽	gunu
扪	gup
捫	gup
捝	guq
撊	guq
揹	guq
㨵	guqc
揃	guqn
撛	guqt
掷	gusc
㩘	guta
搁	gutb
擱	gutb
搼	gutg
挮	guvt
搛	guw
㨛	guwg
搤	guwm
搂	guxk
摟	guxk
搠	guxq
擞	guxt
擻	guxt
㨾	guyi
攁	guyv
抿	gvag
握	gvaj
㨉	gvan
摡	gvaq
摾	gvbl
擗	gvby
抒	gvc
揤	gvc
挶	gvcb
扭	gvf
据	gvfb
㩔	gvfm
搌	gvfq
挦	gvgy
扫	gvh
撖	gvht
拯	gvik
捸	gvio
㨝	gviq
摨	gvit
撏	gvjg
㩇	gvjk
择	gvjl
揆	gvks
撜	gvku
掻	gvl
㩋	gvlr
捅	gvmj
掘	gvmm
把	gvn
掃	gvpm
拫	gvq
揟	gvq
拂	gvr
摊	gvrl
㩌	gvrm
捤	gvta
捃	gvtb
揉	gvtd
摒	gvuf
搦	gvuu
披	gvv
搡	gvvd
撥	gvvm
掇	gvvv
撰	gvvw
㧐	gvvy
抉	gvwg
抳	gvx
㧈	gvx
扠	gvy
択	gvy
搱	gvyf
搔	gvyl
扒	gw
捦	gw
拾	gwb
掵	gwbc
挩	gwbq
撿	gwbw
抢	gwc
㩉	gwcc
捊	gwck
扮	gwco
㧳	gwct
採	gwd
摋	gwdm
抮	gwe
揜	gwf
揺	gwfx
捋	gwgy
拴	gwh
捡	gwik
援	gwkv
掄	gwmf
㩊	gwmg
㩱	gwmg
播	gwn
拎	gwp
授	gwpv
揄	gwqn
揿	gwqw
撳	gwqw
扴	gwr
搯	gwrj
捈	gwt
摇	gwtm
捨	gwtm
撝	gwto
扵	gwu
掙	gwvl
挫	gwwj
攕	gwwk
㧿	gwwl
抡	gwx
㨣	gwxc
挼	gwxk
捴	gwxp
㨙	gwxs
㨑	gwxt
搶	gwyb
摿	gwyn
捻	gwyp
搇	gwyq
扲	gwyv
擒	gwyx
扎	gx
抬	gxb
擸	gxbx
拚	gxf
㩩	gxis
㧠	gxiw
㧄	gxl
㧃	gxl
掼	gxmw
摜	gxmw
㨥	gxmw
指	gxn
摷	gxnd
抁	gxqg
撧	gxqv
㨢	gxqx
拶	gxqy
撪	gxsa
掺	gxse
掾	gxse
摪	gxsg
攭	gxsl
㨧	gxsn
㩪	gxsw
挨	gxts
擬	gxtv
拨	gxty
拇	gxu
捘	gxwt
批	gxx
紥	gxx
拗	gxxc
抝	gxxc
擽	gxxd
摻	gxxe
撡	gxxi
揩	gxxr
払	gxy
拟	gxyw
寸	gy
掊	gyb
搞	gybb
㨯	gybc
㨃	gybc
㧸	gybc
掠	gybi
擅	gybk
揨	gybk
攘	gybq
㩆	gybs
㩝	gybs
撴	gybt
攟	gybt
攍	gyby
㧍	gyc
擠	gycr
㨩	gyct
攠	gydn
擵	gydt
摭	gyfo
擴	gyfw
抆	gyg
拄	gyh
鿜	gykw
掂	gylb
抃	gylg
摘	gymf
抗	gymg
揞	gyn
刌	gyng
撞	gynj
摔	gyof
㩠	gyow
揥	gypm
搒	gypy
挔	gyq
摬	gyqg
掋	gyqy
挤	gyr
㨈	gyr
捬	gyrg
掖	gyry
扩	gys
摌	gyst
揓	gytc
攈	gytd
拉	gyu
攗	gyud
搪	gyvb
掶	gyvw
捽	gywf
㨰	gywq
攡	gywr
挍	gyww
摛	gywx
摝	gyx
接	gyxk
搐	gyxn
㧤	gyxq
擁	gyxr
㧧	gyxr
撤	gyxt
撁	gyxt
㧡	gyxw
拡	gyxy
现	h
长	ha
㺿	ha
䰐	haam
䯷	haas
琖	haat
琙	habk
䰎	habm
鬛	habx
琊	hac
珹	hac
髫	hacb
髢	hacl
䯮	hacp
髤	had
䰊	hadg
䰑	hads
䰍	hadw
鬆	hadx
䰌	hael
䰔	haem
䰉	haem
䯼	haeo
鬚	haes
鬂	haew
䯵	haff
鬍	hafq
䰏	hafr
鬕	hafs
䰒	hafs
髸	hafw
鬒	hafw
髰	hafx
鬗	hafy
髶	hahd
鬊	hahn
䦋	haht
髟	haii
長	haii
镸	haii
髾	haiq
髿	hait
䯯	hait
髻	hajb
鬐	hajn
䰇	hajn
髨	hajq
珬	hak
瑊	hakb
髩	hakc
鬎	hakn
镾	hakw
瓺	haky
玡	hal
䦊	hali
䰕	halm
髭	halx
䯾	hamb
髷	hamf
髠	hamg
䯶	hamh
髯	hamj
髥	hamj
䦉	hamn
鬟	hamq
鬞	hams
䯴	hamv
鬄	hane
䰄	hanp
鬘	hanv
䰋	hanx
鬔	haph
鬃	hapj
鬡	hapk
鬢	hapm
髧	hapq
鬓	hapw
䯺	haqb
鬇	haql
㻸	haqn
鬅	haqq
髱	haqv
镹	haqy
髹	hard
䰓	hary
镽	hasi
䦈	hasj
髬	hask
䯱	hasl
髵	hasm
鬌	hasq
髪	hasv
䰅	hasw
髡	hasx
髮	hasy
髦	hata
髼	hath
䯻	hatj
璼	hatm
髺	hatm
䰖	hatm
鬁	hatn
鬏	hato
镺	hats
镻	hatw
䰀	hatx
鬈	hauc
䰈	hauj
鬋	haun
鬙	haun
鬝	haun
䰃	haun
鬜	hauq
䯸	hauq
䭮	haur
鬀	haut
鬑	hauw
䰆	havd
䰁	havh
肆	havl
镼	havm
䯲	havn
髴	havr
髳	havt
髲	havv
䯹	havv
䯭	havy
䰂	hawd
髽	hawj
鬠	hawn
䯰	hawr
鬉	hawt
䯳	hawx
䦇	hawx
鬖	haxe
鬣	haxx
䯽	hayb
髣	hayc
䯿	hayf
鬤	hayq
㻁	hbb
噩	hbbb
璪	hbbd
䫷	hbbs
珚	hbg
珵	hbh
㻍	hbks
珿	hbll
璝	hblm
璐	hblt
琄	hbq
㻒	hbtd
珈	hcb
玿	hcb
珝	hcc
珕	hccc
玚	hce
㺭	hck
瓍	hcpq
玏	hct
嗸	hctb
聱	hcth
珽	hctj
鳌	hctk
螯	hctl
赘	hctm
嶅	hctm
贅	hctm
熬	hcto
鰲	hcto
鼇	hctp
㥿	hctp
鷔	hctq
獒	hcts
䫨	hcts
摮	hctt
䵅	hctt
骜	hctv
驁	hctv
敖	hctw
鏊	hctw
嫯	hctx
謷	hcty
璆	hcwe
璻	hcyf
耳	hd
聝	hdak
聀	hdat
聖	hdbh
聩	hdbm
聵	hdbm
职	hdbw
耶	hdc
䎲	hdcg
鿣	hdcq
鿤	hdct
鿢	hdcw
琳	hdd
瑮	hdd
䏇	hddj
璴	hddv
聴	hdfp
瑼	hdgy
聑	hdhd
聶	hdhh
聽	hdhp
聙	hdhq
㱌	hdhq
顳	hdhs
聐	hdjb
䎴	hdjr
耺	hdjx
㻬	hdjx
䎸	hdkb
耵	hdkl
聇	hdkl
䏀	hdkn
䏆	hdkn
耻	hdll
䎻	hdmb
聃	hdmj
耼	hdmj
聉	hdmm
㻼	hdnf
刵	hdng
䎶	hdnl
䏉	hdno
聘	hdnx
㷦	hdoo
聎	hdoq
褧	hdoq
耿	hdow
䏄	hdpa
聢	hdpg
聜	hdpj
聺	hdpj
聍	hdpk
聹	hdpk
耽	hdpq
䎵	hdpt
恥	hdpu
璤	hdpu
䏃	hdpw
䏁	hdpy
䎳	hdq
聊	hdqc
䏅	hdqj
䎽	hdqn
聦	hdqp
鵈	hdqx
聸	hdqy
聭	hdrb
聛	hdrf
聰	hdrp
聣	hdrq
䏂	hdrv
瓀	hdsm
聏	hdsm
䏊	hdst
聗	hdsw
耾	hdsx
毦	hdta
䎷	hdti
聕	hdtj
聒	hdtm
䎺	hdtn
䎿	hdto
聅	hdts
聥	hdty
聠	hduf
聪	hdup
联	hdus
鄹	hdvc
郰	hdvc
棸	hdvd
䎼	hdvh
聚	hdvi
埾	hdvj
㔌	hdvn
焣	hdvo
㷅	hdvo
颞	hdvs
聧	hdvs
聂	hdvv
娶	hdvx
取	hdvy
聁	hdwc
聬	hdwc
聄	hdwe
䎾	hdwf
聆	hdwp
聡	hdwp
耹	hdwv
琜	hdww
耴	hdx
聈	hdxc
聨	hdxf
聮	hdxo
聫	hdxs
聯	hdxx
䏈	hdxx
㺷	hdy
職	hdya
聤	hdyk
璷	hdyt
瓆	heem
珩	heg
㻈	hekb
珘	heu
瑽	hewl
弄	hf
瑾	hfbh
瓘	hfbr
琪	hfh
玵	hfj
璂	hfj
瓂	hfjm
璍	hfkj
𫞩	hfkw
玕	hfl
瑛	hfms
瑱	hfmw
璊	hfmy
璜	hfnw
瑚	hfq
㻤	hfqb
璥	hfqt
瓁	hfrv
𤩽	hfsu
璓	hftc
㻳	hftn
珙	hfw
瑹	hfwt
玴	hfx
㻣	hfx
㻡	hfxd
三	hg
球	hgoy
玨	hh
瑘	hhc
珥	hhd
琹	hhd
璱	hhht
㻰	hhhv
琫	hhjl
玤	hhl
瑃	hhn
瑟	hhpt
瑧	hhtd
璈	hhtw
琶	hhvn
㻓	hhvy
珡	hhwg
琴	hhwv
瑇	hhxu
琵	hhxx
珏	hhy
王	hi
璖	hiad
耟	hiav
䣂	hic
耞	hicb
耔	hick
㼍	hiex
耢	hifc
䣢	hifc
䎰	hife
耩	hifm
耤	hifn
耯	hifv
䎯	hifw
耫	hihm
耥	hiib
耒	hiii
耖	hiit
耕	hijr
耘	hijx
琺	hijx
耓	hikl
耡	himc
耝	himh
瑺	himl
琐	himw
瑣	himw
䎬	himx
䎱	himx
璫	hinb
䎪	hing
耦	hiny
耮	hioc
䎦	hioo
䎭	hipt
琑	hiq
耨	hisg
耰	hist
頛	hisw
珖	hisx
䎨	hisx
耗	hita
䎢	hitc
耧	hiux
耬	hiux
耜	hiv
䎤	hivb
珰	hivh
耙	hivn
耚	hivv
耠	hiwb
䎥	hiwb
耣	hiwf
䎫	hiwt
耛	hixb
珱	hixk
䎩	hixn
耭	hixw
䎣	hixw
䎧	hiyb
䎮	hiyf
耲	hiyq
耱	hiys
耪	hiyy
玮	hjc
珪	hjj
玒	hjl
瓄	hjmm
琽	hjn
玩	hjqg
璹	hjvg
瓙	hjvo
玞	hjwg
瓉	hjwm
珯	hjx
㺮	hjx
珐	hjxy
珷	hkal
珂	hkb
㻋	hkbi
瓎	hkbm
㻝	hkbn
玗	hkg
玎	hkl
瑓	hkmi
㻷	hkmi
㺰	hkml
㺻	hkml
瑨	hknn
璢	hknn
玶	hkuk
珸	hkvb
玙	hkx
珁	hkxy
丰	hl
玷	hlb
邫	hlbv
邦	hlc
栔	hlcd
洯	hlci
蛪	hlcl
齧	hlcl
帮	hlcm
幚	hlcm
㓶	hlcn
㓞	hlco
恝	hlcp
觢	hlcq
䚉	hlcq
契	hlcs
䂮	hlcs
䫔	hlcs
挈	hlct
㗉	hlct
㸷	hlct
絜	hlcx
㛃	hlcx
㼤	hlcy
䛚	hlcy
㺪	hlg
焘	hlgo
寿	hlgy
酆	hlhc
豓	hlhm
豔	hlhm
熭	hlho
慧	hlhp
豒	hlht
豐	hlhu
彗	hlhv
艷	hlhv
龶	hlii
㻉	hlit
瓛	hlks
琡	hlkv
勣	hlmc
𪟝	hlmc
琥	hlmg
靑	hlmk
䚍	hlmq
责	hlmw
責	hlmw
琸	hlnf
瓐	hlnm
璿	hlpm
表	hlq
璨	hlqu
艳	hlqv
砉	hls
璩	hlse
剨	hlsn
麺	hltj
鿺	hltq
麹	hltu
㻯	hltu
麦	hltw
麸	hltw
㺳	hlvy
素	hlx
玼	hlx
繛	hlxf
䋤	hlxq
毒	hlxu
纛	hlxx
㺺	hm
㺾	hmb
琠	hmfw
玑	hmg
珇	hmh
珃	hmj
琱	hmjb
瑁	hmjm
珮	hmkm
珟	hmkq
環	hmkq
珊	hmmk
璎	hmmx
瓔	hmmx
现	hmqg
現	hmqg
㻿	hmql
瓗	hmrb
㼇	hmrc
璀	hmrl
瑞	hmsm
珼	hmw
琌	hmwv
㼈	hmxr
玬	hmy
㺬	hmy
琲	hnf
㻫	hnfj
㺫	hng
理	hnj
瑒	hnke
瑅	hnkl
珅	hnl
瑥	hnmn
㻴	hnmv
㻦	hnmy
琩	hnn
瓃	hnnn
玾	hnp
㻛	hnqe
瑆	hnth
璞	hnuh
琾	hnwr
㻀	hnwy
琨	hnxx
琝	hnyg
璟	hnyi
琰	hoow
㼆	hooy
珧	hoqg
𤫉	hoyv
琏	hpaf
珲	hpaf
琿	hpaf
璉	hpaf
瑏	hpal
瑸	hpew
琔	hpg
琮	hpji
琓	hpjq
琎	hpjr
㼀	hpju
瑄	hpkk
璸	hpkm
璌	hpkw
㻞	hpmf
㻘	hpnl
璭	hppa
琬	hpqc
璡	hprl
㻠	hpsu
珌	hpt
㻱	hpth
璲	hpus
琯	hpv
瑢	hpwb
琛	hpwd
瓋	hpyf
青	hq
玥	hq
琘	hqan
玽	hqb
㻊	hqbq
郬	hqc
瑠	hqcn
䨼	hqfv
珎	hqi
靗	hqis
𬍛	hqiw
㻮	hqji
靓	hqmq
靚	hqmq
瑍	hqms
瓊	hqmt
珣	hqn
瑦	hqo
靛	hqpg
㻚	hqq
静	hqql
靘	hqqv
鶄	hqqx
䴖	hqqx
珋	hqtc
靔	hqtc
㻧	hqtd
瑤	hqtm
靝	hqtu
玸	hqv
琤	hqvl
㺵	hqw
靜	hqwl
鳿	hqx
玖	hqy
玓	hqy
玔	hr
玳	hray
瑰	hrb
珦	hrb
㻪	hrcp
琕	hrfg
瑝	hrh
瑖	hrhm
瑔	hrio
璵	hrkw
琟	hrl
㻽	hrlc
珀	hrn
碧	hrs
璁	hrtp
璬	hryt
琢	hse
㻟	hsjq
㺽	hsk
琦	hskb
环	hsl
珔	hslc
瓇	hsmt
珛	hsq
瑌	hssy
珑	hst
瓏	hst
瓑	hstl
㺴	hsu
璙	hsui
顼	hsw
頊	hsw
㺯	hsy
珴	htat
珞	htb
瑀	htby
㻑	htck
琇	htcp
㻔	htfk
璑	htfo
珄	hth
琒	hthl
璳	htim
珠	htiw
玝	htk
㻄	htkl
珤	htm
琍	htng
珗	htqg
瓒	htqm
瓚	htqm
瓈	htqw
琁	htvl
㻶	htvl
瑡	htvm
玫	htw
珻	htxu
㻥	hudk
㻂	huf
㺶	hufg
班	huh
珜	huh
瑳	hujl
瓓	huki
璔	humn
瑐	huqn
璘	huqt
㼁	huta
珶	huvt
㻩	huw
琷	hux
㻲	huxk
玛	hv
瑪	hv
珉	hvag
瑉	hvan
瑋	hvbt
㻵	hvcc
㺲	hvf
琚	hvfb
𬍤	hvgy
琭	hvh
㻖	hvio
璕	hvjg
瑕	hvjv
玘	hvk
璒	hvku
珒	hvl
㺼	hvl
璶	hvlm
璛	hvlr
瑂	hvm
㻕	hvmm
鿱	hvn
㻏	hvow
珢	hvq
珺	hvtb
璚	hvtb
瑈	hvtd
玻	hvv
玦	hvwg
瑵	hvyl
兲	hw
玐	hw
琻	hw
珨	hwb
玱	hwc
琈	hwck
玢	hwco
珍	hwe
㻇	hwh
泰	hwio
㤗	hwiw
奉	hwjl
䳞	hwjq
㻅	hwjx
奏	hwks
瑗	hwkv
㫪	hwln
璯	hwmn
春	hwn
璠	hwn
蠢	hwnl
惷	hwnp
玲	hwp
璦	hwpt
瑷	hwpv
瑜	hwqn
玠	hwr
㦼	hwra
舂	hwrj
瑫	hwrj
憃	hwrp
䚎	hwrq
琋	hwsm
㻌	hwt
秦	hwtd
瑶	hwtm
䆐	hwtt
㻜	hwwl
玜	hwxy
琀	hwyb
瑲	hwyb
玪	hwyv
玌	hx
珆	hxb
㼃	hxbx
㺹	hxf
璏	hxkx
㺩	hxl
瑻	hxmw
璅	hxnd
㻆	hxq
玧	hxqg
瑙	hxrw
瑑	hxse
㻐	hxwt
玭	hxx
瓅	hxxd
㼄	hxxn
瑎	hxxr
璣	hxxw
丟	hxy
㺨	hxy
玉	hy
玊	hy
琂	hy
琣	hyb
琼	hybi
璮	hybk
瓖	hybq
㻻	hybt
瑯	hyc
璾	hycr
珳	hye
璋	hyfg
㼅	hyfw
玟	hyg
斑	hyh
玣	hylg
瓌	hymq
㻭	hyof
𤧛	hypm
璄	hyqg
㻢	hytc
璇	hytv
琅	hyv
瑭	hyvb
琗	hywf
珓	hyww
璃	hywx
珫	hyxq
㻙	hyxq
琉	hyxr
玹	hyxx
少	i
汇	ia
洍	ia
淺	iaat
漚	iabb
淢	iabk
㵄	iabs
沏	iaco
柒	iad
䤔	iaed
聻	iaeh
壍	iaej
渐	iaek
漸	iaek
魙	iaer
嬱	iaex
㳦	iaf
㲺	iag
洭	iah
洷	iaj
減	iakb
滅	iako
澸	iakp
浳	iaq
潛	iaqn
灊	iaqu
滙	iarl
㶊	iasw
浇	iasx
浅	iat
㳀	iat
瀶	iatb
濫	iatm
灠	iatq
㴛	iatw
洰	iav
渠	iavd
瀭	iawn
沤	iawy
泧	iax
㵴	iaxa
㳚	iay
漍	ibak
洄	ibb
澡	ibbd
潬	ibbf
澏	ibbm
漶	ibbp
湂	ibbx
涃	ibd
㳭	ibd
涸	ibfb
洇	ibg
浧	ibh
濈	ibha
湒	ibhd
塣	ibhj
𬇹	ibhy
涠	ibjc
洖	ibks
沖	ibl
浞	ibll
溃	iblm
潰	iblm
潞	iblt
涢	ibm
溳	ibm
涡	ibmw
渑	ibnx
涓	ibq
況	ibqg
溷	ibse
浥	ibvn
潿	ibvt
泅	ibwg
溫	ibwm
㴄	ibwm
㳏	ibwy
氾	ic
沼	icb
泀	icb
泇	icb
濻	icbm
㵑	icbm
㴠	icbx
㵫	iccn
泐	icct
汤	ice
烫	iceo
𬍡	icey
汛	icfg
㲸	icg
汈	ick
汓	ick
池	icl
䀀	icmn
㳱	icn
瀷	icnw
瀈	icpa
瀡	icpq
濯	icrl
漝	icrn
㵤	icsw
氻	ict
涏	ictj
涎	ictl
漋	ictt
湕	icvl
溋	icvm
漻	icwe
䀊	icwm
㶏	icwp
滁	icwt
汲	icy
㲽	icy
瀥	icyb
鿄	icyd
濢	icyf
涩	icyl
澀	icyl
涊	icyp
沐	id
㳈	id
淋	idd
溧	idd
潹	iddd
瀮	iddd
漜	iddj
澿	iddj
灀	iddm
澘	iddn
潸	iddq
濋	iddv
漤	iddx
滼	iddy
涁	ide
淅	idek
灞	idfq
㶚	idfq
㶇	idfw
洒	idg
溥	idgy
漙	idgy
㳹	idh
湮	idj
㵱	idjg
漂	idji
渿	idji
溎	idjj
澐	idjx
酒	idk
泍	idk
湘	idm
㵢	idnb
潭	idnf
渣	idnk
潓	idpu
㵡	idqv
瀖	idrl
湐	idrn
濡	idsm
灪	idte
浦	idu
潥	idud
瀒	idwb
漆	idwi
澪	idwp
淶	idww
淞	idwx
㳐	idx
㜑	idxk
㴗	idxk
沭	idy
㴤	idyh
㵌	ieem
洐	ieg
沠	iei
垽	iej
潴	iejn
沂	iek
㳋	iek
洉	iekb
浜	iekw
漇	iell
㴲	ielm
瀊	iemm
瀓	iemt
㵟	iemt
峾	iemx
㴈	iemx
派	ieq
漪	iesb
潃	ietq
澓	iett
洀	ieu
溵	ievm
汳	ievy
漎	iewl
泒	iex
泝	iey
㶓	ifaa
灆	ifam
沽	ifb
渽	ifb
漌	ifbh
灌	ifbr
灘	ifbr
漢	ifbw
湈	ifd
溨	ifd
澌	ifek
泋	iff
㴖	iff
㵩	iffd
濆	iffm
𣸣	iffm
汁	ifg
淇	ifh
泔	ifj
濭	ifjm
渮	ifkb
澕	ifkj
懑	ifkp
满	ifkw
汗	ifl
淽	ifll
淔	ifmh
溝	ifmj
満	ifmm
懣	ifmp
渶	ifms
滇	ifmw
滿	ifmy
瀎	ifmy
㳻	ifn
渵	ifnb
瀚	ifnc
漧	ifnc
澣	ifnf
濣	ifnf
鿰	ifnj
瀐	ifnk
濗	ifnm
潮	ifnq
漠	ifns
潢	ifnw
瀻	ifnw
㵧	ifnw
澫	ifny
渤	ifpc
涝	ifpc
浡	ifpc
溁	ifpd
滞	ifpm
濛	ifps
㴾	ifpt
潆	ifpx
溹	ifpx
滢	ifpy
湖	ifq
㳳	ifqg
滯	ifqm
濍	ifqp
懘	ifqp
潵	ifqt
㵶	ifrl
濩	ifrv
㳸	ifrx
渃	ifsb
漭	ifsf
㴕	iftd
㴀	iftp
湳	ifu
灡	ifui
潇	ifvr
瀟	ifvr
渎	ifvs
汥	ifvy
洪	ifw
溚	ifwb
濸	ifwb
港	ifwv
鍙	ifww
泄	ifx
湛	ifx
濝	ifx
渫	ifxd
淓	ifyc
㵏	ifyf
㳤	ifyi
瀳	ifyo
㵁	ifyr
浙	igek
浗	igoy
㳺	igtc
湁	igwb
汪	ih
涱	iha
潔	ihcx
洱	ihd
㳥	ihf
涛	ihgy
灄	ihhh
灩	ihhm
濏	ihht
灃	ihhu
潖	ihhv
灧	ihhv
洡	ihi
溙	ihio
淎	ihjl
湊	ihks
沣	ihl
淸	ihmk
㵾	ihmq
渍	ihmw
漬	ihmw
湷	ihn
㴷	ihpq
清	ihq
瀞	ihql
滟	ihqv
濪	ihqv
湱	ihs
溱	ihtd
滶	ihtw
㵵	ihvi
滠	ihvv
溸	ihx
㳧	ihx
㶌	ihxx
㵉	iidd
㵜	iifu
㶂	iifw
氵	iiii
渁	iiio
漟	iij
㴣	iikw
淌	iimb
灙	iimo
溑	iimw
涾	iin
澢	iinb
㶙	iint
消	iiq
洲	iir
㴢	iirl
㴺	iisw
洸	iisx
㳲	iisy
沙	iit
乷	iitc
桬	iitd
鲨	iitk
渻	iitm
鯊	iito
㶃	iito
裟	iitq
硰	iits
挲	iitt
㸺	iitt
㲚	iitt
䣉	iitv
娑	iitx
㵈	iixf
㶝	iiyp
汢	ij
洁	ijb
㵙	ijbb
澎	ijbe
澍	ijbg
溒	ijbq
𣲗	ijc
涍	ijck
漖	ijct
洔	ijgy
沶	iji
沬	ijiw
洼	ijj
湗	ijjg
澆	ijjs
洘	ijkx
江	ijl
㴂	ijmj
瀆	ijmm
㳩	ijmy
渚	ijn
㵭	ijow
濲	ijpm
瀔	ijpm
瀫	ijpm
涜	ijpq
潱	ijpu
沅	ijqg
鸿	ijqx
鴻	ijqx
汫	ijr
㴳	ijse
澒	ijsw
涬	ijuj
濤	ijvg
濇	ijwb
淕	ijwj
濽	ijwm
潜	ijwn
浾	ijwr
淩	ijwt
污	ijx
汚	ijx
㳣	ijx
溘	ijxm
法	ijxy
沄	ijxy
河	ikb
滒	ikbb
㴻	ikbg
涑	ikbi
瀜	ikbl
濑	ikbm
瀨	ikbm
湢	ikbn
溂	ikbn
漱	ikbq
灢	ikbq
瀬	ikbs
潄	ikbt
浢	ikbu
滆	ikbu
𬇕	ikct
沫	ikd
汧	ikf
汙	ikg
盓	ikgm
汀	ikl
沔	iklc
泟	ikll
漹	iklo
洓	ikmi
湅	ikmi
洅	ikmj
沛	ikml
沞	ikml
漕	ikmn
灑	ikmy
洌	ikng
涷	ikni
洹	iknk
溍	iknn
澑	iknn
浭	iknw
添	iksi
㴁	iksr
㴿	iksw
𣲘	iksx
涞	ikud
泙	ikuk
浃	ikus
浯	ikvb
洟	ikvw
淒	ikvx
兴	ikw
举	ikwj
挙	ikwt
濔	ikww
誉	ikwy
汅	ikx
涇	ikxj
溼	ikxj
沍	ikxk
沌	ikxx
浊	il
濊	ilat
沾	ilb
滷	ilbo
惉	ilbp
澞	ilbs
濒	ilis
瀕	ilis
涉	ilit
渉	ilit
渱	iljl
淑	ilkv
沚	ill
澁	illl
滮	ilme
淲	ilmg
浈	ilmw
湞	ilmw
淖	ilnf
瀘	ilnm
濾	ilnp
渋	ilo
濬	ilpm
滤	ilpu
㵃	ilpx
瀣	ilqk
澯	ilqu
澽	ilse
滹	iltu
泸	ilvt
泚	ilx
灗	ilyk
泪	im
濺	imaa
溅	imat
沿	imb
泂	imb
浀	imfk
灎	imfm
濃	imfs
㵹	imfs
澧	imfu
灔	imfv
淟	imfw
㲹	img
沮	imh
㴥	imiq
渺	imit
濹	imj
淍	imjb
鼡	imjl
㴘	imjm
濖	imjn
澤	imju
洞	imkb
㴐	imkc
洬	imkq
澴	imkq
㵯	imkq
溦	imkt
澂	imkt
溰	imku
泏	imm
灈	immr
㶔	imms
㵋	immw
瀴	immx
泗	imn
㳑	imn
瀃	imne
测	imng
測	imng
潉	imnx
潶	imo
滑	imp
漴	impj
涀	imqg
濁	imql
漰	imqq
濉	imrl
漼	imrl
潀	imrw
潈	imse
漄	imsj
湍	imsm
瀱	imsn
湠	imso
湨	imsu
泱	imsy
溄	imtj
渢	imtl
潂	imun
没	imv
渦	imvb
浿	imw
𬇙	imw
浻	imwb
汭	imwg
涔	imwv
沨	imwy
汕	imx
濎	imxv
汎	imy
浵	imye
盕	imym
汩	in
汨	in
沺	inb
畄	inb
溻	incc
巣	ind
淉	ind
渄	inf
戦	infa
単	infg
瀑	infi
滭	infj
涆	infl
潩	infw
㵊	inhv
滉	inis
涅	inj
浬	inj
溡	injg
濐	injn
泹	ink
湯	inke
淂	inkg
湜	inkl
浉	inkm
盪	inkm
燙	inko
渨	inkq
淠	inkr
淏	inks
獣	inks
涄	inkx
璗	inky
温	inmn
漫	inmv
湡	inmy
澷	inmy
淐	inn
灅	innj
㵽	innn
湿	innu
㶟	innx
油	ino
㳌	inp
㴓	inpu
渭	inq
㵣	inqq
渴	inqw
渇	inqx
㶋	inst
湦	inth
㵆	intj
滥	intm
濧	inug
澲	inuh
溿	inuj
灇	inuv
溭	inwt
漯	inx
濕	inxo
灦	inxs
洩	inxt
混	inxx
渂	inyg
澋	inyi
㶞	inyq
灏	inys
灝	inys
水	io
呇	iob
㴅	iobb
浺	iobl
頮	iofs
颒	iofs
淼	ioii
乑	ioii
氺	ioii
㴇	ioii
㵘	ioii
沝	ioio
濷	ioiy
坔	ioj
泴	iomn
沓	ion
畓	ionb
瀯	ioob
澇	iooc
濚	iood
濴	iooi
㶈	iool
濙	iooo
淡	ioow
灐	ioow
瀠	ioox
瀅	iooy
洮	ioqg
㳫	iorj
沯	ios
湉	iotm
沀	iovc
氼	iowg
凼	ioxl
党	ip
浑	ipaf
涟	ipaf
渾	ipaf
漣	ipaf
潌	ipaj
牚	ipal
営	ipbb
㴦	ipbb
瀢	ipbm
滬	ipbv
㵳	ipce
学	ipck
労	ipct
敩	ipct
棠	ipd
栄	ipd
浨	ipd
淭	ipd
滨	ipew
溛	ipex
甞	ipfj
瀽	ipfl
黉	ipfw
淀	ipg
㳡	ipgy
㴏	iph
瀗	iphp
龸	ipii
泶	ipio
㴃	ipio
堂	ipj
坣	ipj
䣘	ipjc
淙	ipji
漥	ipjj
涳	ipjl
浣	ipjq
溕	ipjs
澾	ipju
滱	ipjv
尝	ipjx
渲	ipkk
泞	ipkl
濱	ipkm
演	ipkw
泻	ipkx
瓽	ipky
蛍	ipl
䟫	ipll
漃	iplv
㴭	ipm
濄	ipmb
䣣	ipmc
㴜	ipmf
沉	ipmg
常	ipml
黨	ipmo
㦂	ipmp
觉	ipmq
覚	ipmq
㶎	ipmq
赏	ipmw
賞	ipmw
峃	ipmx
當	ipnb
㼕	ipne
渖	ipnl
㵓	ipnl
劏	ipnn
溟	ipnw
㽆	ipny
濘	ippk
澝	ippm
滵	ippm
㵥	ippm
淧	ippt
浓	ipq
涴	ipqc
沈	ipqg
鲎	ipqk
㗬	ipqq
鴬	ipqx
鸴	ipqx
㴶	iprl
㴼	iprn
瀉	ipro
㵼	ipro
𬒈	ips
㵦	ipsq
涋	ipsu
淚	ipsu
湥	ipsu
㴱	ipsu
浤	ipsx
涙	ipsy
㳠	ipsy
泌	ipt
掌	iptg
漨	ipth
喾	iptj
㳴	iptj
浶	iptl
㴵	iptm
沁	ipu
㴹	ipud
澻	ipus
沪	ipv
涫	ipv
濵	ipvm
㵠	ipvm
濅	ipvv
泬	ipw
溶	ipwb
滘	ipwb
深	ipwd
浫	ipwf
瀋	ipwn
沱	ipx
澠	ipx
洝	ipxk
嘗	ipxn
滓	ipyf
裳	ipyq
㳉	iq
汦	iqag
涽	iqan
泜	iqay
泃	iqb
洺	iqb
浼	iqbq
潒	iqbs
瀺	iqby
㶀	iqce
㵬	iqcm
溜	iqcn
瀏	iqcn
澥	iqct
染	iqd
沕	iqe
㳷	iqen
淴	iqep
㳃	iqfg
沵	iqi
泺	iqiw
漈	iqji
渔	iqk
澛	iqkn
盜	iqmn
涣	iqms
渙	iqms
洵	iqn
溩	iqo
瀂	iqon
㶍	iqou
漁	iqow
濥	iqpw
淜	iqq
淊	iqrj
㵻	iqrv
洈	iqsc
澹	iqsy
氿	iqt
泖	iqtc
滐	iqtd
淘	iqtm
汮	iqu
淗	iqud
㴨	iqus
泡	iqv
浄	iqvl
淝	iqvn
㴔	iqvp
沒	iqvy
㳄	iqw
洶	iqwx
㴯	iqxn
湚	iqxq
沟	iqxy
汐	iqy
汋	iqy
汍	iqy
汣	iqy
渹	iqy
州	ir
汌	ir
淵	ir
浌	irat
溾	irb
湺	irbd
㳞	irbl
潗	ird
㴪	ird
㳜	ird
渒	irfg
準	irfg
泭	irgy
㴬	irgy
湟	irh
湶	irio
湼	irjl
鼝	irjv
澙	irko
㵰	irkw
淮	irl
滌	irld
㶖	irlm
滺	irlp
滫	irlq
浟	irlt
洎	irm
淿	irml
泊	irn
濞	irnr
濮	irnu
潐	irow
㴧	irpu
淣	irqg
潟	irqo
㵿	irrr
滜	irsf
溴	irsu
洑	irsu
澔	irtj
㳝	irtj
漗	irtp
渊	irud
澳	irus
澚	irux
沜	irv
洢	irvt
溲	irvy
㶅	irwc
溣	irwf
㳛	irwg
灚	irwq
沎	irx
漑	irxq
激	iryt
涖	iryu
沰	is
滣	isb
㳓	isb
㳪	isb
湎	isbj
沥	isct
涿	ise
浝	ise
㙙	isej
渀	isff
㵮	isff
濿	isfy
溽	isgy
浱	isj
㴎	isji
涯	isjj
瀦	isjn
㵔	isjn
洿	isjx
渏	iskb
㳅	isl
洊	islc
洏	ism
㳍	isml
瀀	ismt
洦	isn
㴟	isnc
湹	isnj
淹	isnx
洃	isow
洧	isq
漘	isq
源	isri
渜	issy
泷	ist
瀧	ist
瀝	istl
汱	isu
潦	isui
㵐	isuq
厳	isvt
沷	isvy
湏	isw
㳁	iswg
浹	isww
漺	isww
沋	isx
汯	isxy
㳒	isxy
汰	isy
汏	isy
汑	itag
涐	itat
洛	itb
潪	itbn
渪	itby
汽	itc
汔	itcg
㳵	itck
沲	itcl
涤	itd
㶘	itdf
汘	itfg
㵇	itfj
涶	itfk
潕	itfo
㴙	itfr
㵲	itft
泩	ith
浲	ithl
潲	itiq
洙	itiw
浩	itj
澨	itjw
汻	itk
湃	itkh
湩	itkj
湰	itkt
汼	itl
泎	itlg
活	itm
潨	itmi
洫	itmn
淛	itmn
瀩	itms
㴡	itn
漡	itne
浰	itng
㵞	itop
湫	itow
泛	itp
洗	itqg
灒	itqm
濳	itqn
鍌	itqw
㵺	itrf
潅	itrl
㳢	itsr
鋈	itsw
沃	itsy
滗	itta
洚	ittj
泈	itu
滊	itud
泘	ituk
㶕	itun
溗	itux
瀄	itvc
潷	itvl
㳬	itvl
溮	itvm
汷	itw
㳊	itw
泆	itwg
潻	itwi
塰	itxj
涹	itxk
泲	itxt
海	itxu
瀿	itxx
灛	iubf
淃	iuc
沩	iucy
洣	iud
澖	iud
澊	iudg
湭	iudk
洴	iuf
㳆	iufg
渆	iufn
洋	iuh
润	iuh
潤	iuh
㳕	iuh
漛	iuio
泮	iuj
溠	iujl
澜	iuki
瀾	iuki
潧	iumn
潎	iumt
涧	iun
澗	iun
潽	iunn
湴	iunu
瀵	iunw
溔	iuow
㵍	iupu
涚	iuq
㵎	iuq
澬	iuqm
湔	iuqn
㶄	iuqr
潾	iuqt
湵	iuqy
灁	iuri
渞	iurm
㴚	iuse
渕	iusn
浂	iusy
渼	iusy
濶	iutm
㵛	iuub
灍	iuuq
㵪	iuuq
㶒	iuv
溈	iuvo
涕	iuvt
溓	iuw
㴸	iuwg
溢	iuwm
潫	iux
㳾	iux
溇	iuxk
漊	iuxk
㴊	iuxn
濨	iuxp
溯	iuxq
滋	iuxx
溬	iuxx
潣	iuyg
漾	iuyi
瀁	iuyv
溤	iv
泯	ivag
渥	ivaj
湣	ivan
溉	ivaq
漒	ivbl
湋	ivbt
澼	ivby
汿	ivc
潺	ivcc
漏	ivdo
沑	ivf
涺	ivfb
澱	ivfm
浔	ivgy
㳔	ivgy
渌	ivh
涨	ivha
漲	ivha
渳	ivhd
澉	ivht
㴍	ivih
洆	ivik
灟	ivil
㳮	ivio
㴮	iviq
㴋	ivir
漽	ivit
涵	ivix
泾	ivj
堻	ivj
潯	ivjg
澅	ivjk
泽	ivjl
潳	ivjn
溌	ivjq
溊	ivjv
湀	ivks
澄	ivku
瀰	ivkw
津	ivl
濜	ivlm
潚	ivlr
湄	ivm
湧	ivmc
涌	ivmj
淈	ivmm
涮	ivmn
慂	ivmp
㶠	ivmu
汜	ivp
㴆	ivpm
浸	ivpv
泿	ivq
湑	ivq
㳽	ivqi
泦	ivqt
沸	ivr
滩	ivrl
㵒	ivrm
碆	ivs
滪	ivsw
澦	ivsw
浘	ivta
涒	ivtb
潏	ivtb
㴫	ivtc
渘	ivtd
㨇	ivtg
㶜	ivun
溺	ivuu
波	ivv
潑	ivvm
涰	ivvv
潠	ivvw
錃	ivw
決	ivwg
泥	ivx
埿	ivxj
婆	ivxk
泓	ivxy
汉	ivy
汊	ivy
沢	ivy
㳗	ivyj
溞	ivyl
浕	ivyu
小	iw
淦	iw
汃	iw
洽	iwb
瀹	iwbf
㵸	iwbf
涗	iwbq
㶑	iwbq
瀲	iwbt
澰	iwbw
㕾	iwbx
沧	iwc
潝	iwcc
㐢	iwcc
梁	iwcd
浮	iwck
湓	iwcm
汾	iwco
粱	iwcu
㳶	iwcx
沴	iwe
渰	iwf
㽏	iwfj
汄	iwg
㶁	iwgm
浖	iwgy
洤	iwh
尛	iwii
潋	iwit
尘	iwj
塗	iwj
濦	iwjp
渓	iwjw
浍	iwjx
湲	iwkv
㴞	iwln
潊	iwlv
尚	iwmb
尙	iwmb
䣊	iwmc
䣔	iwmc
淪	iwmf
㢢	iwmf
灂	iwmg
幤	iwmm
㲂	iwmm
澮	iwmn
漞	iwmq
覍	iwmq
敞	iwmt
氅	iwmt
潘	iwn
虩	iwnm
泠	iwp
㴽	iwpu
涭	iwpv
肖	iwq
洕	iwq
削	iwqn
渝	iwqn
揱	iwqt
㲖	iwqt
滔	iwrj
雀	iwrl
蠽	iwrl
㝸	iwrq
辉	iwsa
輝	iwsa
尜	iwsi
䆪	iwsj
㒯	iwsj
浠	iwsm
淆	iwsq
耀	iwsr
韑	iwst
黋	iwsw
兤	iwsw
光	iwsx
尡	iwsx
尖	iwsy
涂	iwt
少	iwt
劣	iwtc
淫	iwtj
省	iwtm
涻	iwtm
滛	iwtm
潙	iwto
䲵	iwtq
䚇	iwtq
毟	iwtt
漵	iwtw
㝹	iwty
㼳	iwty
湌	iwv
当	iwvh
淨	iwvl
㓥	iwvn
溆	iwvy
浴	iwwb
瀸	iwwk
滏	iwwu
㵚	iwww
㳇	iwwy
沦	iwx
滃	iwxc
浽	iwxk
汹	iwxl
鸂	iwxq
㶉	iwxq
溪	iwxs
㳂	iwxy
尐	iwy
㲼	iwy
浛	iwyb
滄	iwyb
㵅	iwym
淰	iwyp
汵	iwyv
治	ixb
洳	ixb
灉	ixbr
㴩	ixbv
㵖	ixbx
㖳	ixbx
㳎	ixf
㴌	ixfb
汝	ixk
淥	ixki
滍	ixkl
湽	ixkn
㳨	ixkq
淄	ixnb
漅	ixnd
㴴	ixoo
㳙	ixq
沇	ixqg
㴰	ixqx
潍	ixrl
濰	ixrl
渗	ixse
湪	ixse
洠	ixtl
涘	ixts
泼	ixty
浚	ixwt
沘	ixx
泑	ixxc
濼	ixxd
滲	ixxe
㵕	ixxi
㴉	ixxj
湝	ixxr
灤	ixyd
灣	ixyv
泤	ixyw
汒	iya
涪	iyb
滈	iybb
淳	iybc
涥	iybc
漷	iybc
涼	iybi
澶	iybk
渟	iybk
湸	iybm
湻	iybn
滖	iybq
瀼	iybq
濠	iybs
潡	iybt
澟	iybt
瀛	iyby
灜	iyby
汸	iyc
濟	iycr
澵	iyde
灖	iydn
瀙	iydq
㳯	iyf
漳	iyfg
灨	iyfm
㵂	iyfo
渡	iyfv
瀇	iyfw
汶	iyg
注	iyh
乼	iyhc
㗟	iyhx
泳	iyio
㶆	iyjn
灋	iykx
汴	iylg
滳	iymb
滴	iymf
沆	iymg
瀤	iymq
湆	iyn
浏	iyng
鿌	iyni
潼	iynj
瀍	iynj
滝	iynx
瀌	iyow
渧	iypm
澺	iypu
滂	iypy
湇	iyq
㳖	iyq
㵝	iyqb
滰	iyqg
济	iyr
済	iyr
㶐	iyrp
液	iyry
浐	iys
㲿	iys
滻	iyst
濓	iysw
游	iytc
湤	iytc
浒	iytk
滸	iytk
㵀	iytt
漩	iytv
㶛	iytw
泣	iyu
濂	iyuw
㴑	iyux
浪	iyv
溏	iyvb
漮	iyvi
滽	iyvl
滦	iywd
淬	iywf
㴒	iywf
滚	iywq
渷	iywq
滾	iywq
洂	iywr
灕	iywr
湙	iyws
滧	iywt
淤	iywu
湾	iywv
洨	iyww
漓	iywx
漉	iyx
㳿	iyxd
㳰	iyxf
淁	iyxk
滀	iyxn
淯	iyxq
㳘	iyxq
流	iyxr
澭	iyxr
澈	iyxt
鎏	iyxw
泫	iyxx
瑬	iyxy
土	j
塸	jabb
域	jabk
㙺	jabm
城	jac
墭	jacm
垤	jaj
堿	jakb
㙳	jakp
㙎	jakx
墄	jali
堰	janx
壏	jatm
𫭟	jawy
吉	jb
墠	jbbf
壧	jbbt
堮	jbbx
郆	jbc
翓	jbcc
劼	jbct
㔛	jbct
㙅	jbd
堌	jbfb
㘻	jbg
埕	jbh
喆	jbjb
嚞	jbjb
墤	jblm
埙	jbm
塤	jbm
埚	jbmw
㓤	jbng
臺	jbpa
袁	jbq
埍	jbq
欯	jbqw
鴶	jbqx
颉	jbsw
頡	jbsw
喜	jbub
嘉	jbub
嚭	jbub
囍	jbub
鼛	jbub
䵿	jbub
彭	jbue
鼙	jbuf
尌	jbug
鼚	jbuh
鼞	jbuj
噽	jbuk
壴	jbuk
蟚	jbul
鼜	jbul
瞽	jbum
䶁	jbun
熹	jbuo
憙	jbup
歖	jbuq
㰻	jbuq
鼘	jbur
鼕	jbuu
鼟	jbuu
鼓	jbuv
壾	jbuv
敼	jbuv
皷	jbuv
鼔	jbuv
䥢	jbuw
䶀	jbuw
䵽	jbux
甏	jbuy
㐖	jbx
韦	jc
壭	jc
㙝	jccq
韧	jccy
垜	jcd
场	jce
㐊	jcg
㐋	jcg
地	jcl
韫	jcnm
韨	jcsy
㘦	jct
埏	jctl
𪤗	jcwe
韬	jcwr
圾	jcy
塛	jdd
壩	jdfq
塼	jdgy
㙛	jdgy
堙	jdj
墂	jdji
墵	jdjx
墰	jdnf
壖	jdsm
埔	jdu
㙘	jdxk
垳	jeg
圻	jek
坵	jek
垢	jekb
㙃	jekw
坂	jevy
㙡	jewl
坬	jex
坼	jey
墐	jfbh
壦	jfbr
墳	jffm
㙋	jfh
坩	jfj
壒	jfjm
墸	jfjn
墷	jfkj
埴	jfmh
壊	jfmq
㙹	jfmq
填	jfmw
㙢	jfmy
墘	jfnc
塻	jfns
墴	jfnw
𫭼	jfpc
墆	jfqm
埖	jfrx
墙	jfub
垬	jfw
塔	jfwb
塨	jfwi
塂	jfwv
㘷	jfwy
堪	jfx
墈	jfxc
堞	jfxd
塃	jfyr
二	jg
邿	jgc
剺	jgic
孷	jgic
漦	jgii
釐	jgij
䙿	jgiq
氂	jgit
犛	jgit
㹈	jgit
㲠	jgit
未	jgiw
斄	jgiw
嫠	jgix
㖝	jgix
亖	jgjg
亍	jgl
㱏	jgll
㱐	jgly
忈	jgpu
兘	jgqb
邧	jgqc
㪴	jgqf
元	jgqg
㝴	jgqg
㒬	jgqh
坖	jgqj
刓	jgqn
黿	jgqp
䲮	jgqq
䲶	jgqq
顽	jgqs
頑	jgqs
㒮	jgqs
㹕	jgqt
鼋	jgqx
井	jgr
亓	jgr
刱	jgrc
㣋	jgre
汬	jgri
坓	jgrj
㓝	jgrn
㐩	jgrr
丼	jgry
辇	jgwa
輦	jgwa
邞	jgwc
鄻	jgwc
鄼	jgwc
䣠	jgwc
椝	jgwd
槼	jgwd
夫	jgwg
賛	jgwm
替	jgwn
规	jgwq
規	jgwq
鳺	jgwq
鬶	jgwu
鬹	jgwu
㚘	jgww
嫢	jgwx
亏	jgx
亐	jgx
动	jgxc
䢵	jgxc
叇	jgxi
䲰	jgxq
魂	jgxr
䰟	jgxr
叆	jgxv
云	jgxy
寺	jgy
㙊	jha
垹	jhc
埲	jhjl
堾	jhn
埥	jhq
塐	jhx
壣	jhxx
示	ji
士	jiii
祘	jiji
埫	jimb
壋	jinb
垙	jisx
垱	jivh
墚	jiwd
礼	jix
圭	jj
郌	jjbv
邽	jjc
劸	jjct
鞤	jjgf
堼	jjgj
幇	jjgm
幫	jjgm
犎	jjgt
㨍	jjgt
㜂	jjgx
封	jjgy
垚	jjj
壵	jjj
翹	jjjc
㙓	jjjj
䴃	jjjq
堯	jjjs
墝	jjjs
顤	jjjs
㚁	jjjs
㘼	jjkx
䖯	jjl
卦	jjlg
㪈	jjlv
堵	jjn
刲	jjng
恚	jjpu
㙪	jjpu
鼃	jjpx
䵷	jjpx
坃	jjqg
款	jjqw
㰪	jjqw
䳏	jjqx
㘫	jjr
壔	jjvg
隷	jjvi
墻	jjwb
堎	jjwt
圬	jjx
坛	jjxy
奊	jjxy
坷	jkb
堛	jkbn
㚂	jkbq
塥	jkbu
圩	jkg
圢	jkl
圷	jklg
墕	jklo
堜	jkmi
埬	jkni
垣	jknk
壃	jknk
㙧	jknn
垭	jknu
埡	jknu
埂	jknw
坪	jkuk
坘	jkxk
坉	jkxx
工	jl
坫	jlb
塷	jlbo
㠬	jlbw
㼭	jlby
邛	jlc
卭	jlc
垇	jlck
㓛	jlco
功	jlct
㧭	jlct
巭	jlcw
㣉	jle
圤	jlg
汞	jlio
埗	jlit
㠭	jljj
垰	jljl
圵	jlk
㚀	jlka
㤍	jlkp
䲾	jlkq
埱	jlkv
巧	jlkx
㚽	jlkx
瓨	jlky
䛒	jlky
址	jll
䡗	jlma
鞏	jlmf
㙈	jlmg
聓	jlmh
蛩	jlml
跫	jlml
盐	jlmn
恐	jlmp
慐	jlmp
䂬	jlms
䅃	jlmt
㧬	jlmt
䊄	jlmu
贡	jlmw
銎	jlmw
巬	jlmw
貢	jlmw
㠫	jlmw
巩	jlmy
㼦	jlmy
㓚	jlng
壚	jlnm
墟	jlnu
龼	jlpm
䲨	jlqx
壉	jlse
项	jlsw
項	jlsw
㙤	jltu
攻	jltw
垆	jlvt
觋	jlwq
覡	jlwq
鵐	jlwq
鹀	jlwq
巫	jlww
击	jlxl
坰	jmb
夁	jmbf
垛	jmd
㙉	jmfw
坥	jmh
㘱	jmj
墿	jmju
垌	jmkb
堽	jmkl
㱿	jmkm
塏	jmku
覿	jmmq
皾	jmmv
賣	jmmw
垷	jmqg
塴	jmqq
墔	jmrl
堓	jmsf
㙐	jmsm
坱	jmsy
堸	jmtl
堈	jmum
坄	jmv
堝	jmvb
垲	jmvk
坝	jmw
垻	jmw
埧	jmw
埛	jmwb
㘨	jmwg
埁	jmwv
圸	jmx
䵺	jmxv
坍	jmy
塄	jmyc
者	jn
䡤	jnaf
㗯	jnbx
都	jnc
塌	jncc
翥	jncc
乽	jncg
䬡	jncu
堁	jnd
壜	jndx
斱	jnek
垾	jnfl
埘	jngy
埋	jnj
㘿	jnj
塒	jnjg
坦	jnk
場	jnke
堤	jnkl
㙗	jnkq
坤	jnl
䘄	jnll
塭	jnmn
覩	jnmq
墁	jnmv
殾	jnmv
堣	jnmy
㙼	jnnn
煮	jnow
煑	jnow
㙕	jnq
埸	jnqe
堨	jnqw
䰩	jnrb
墣	jnuh
䎞	jnv
堺	jnwr
㙷	jnxo
堒	jnxx
堩	jokk
埮	joow
垗	joqg
灻	jow
塉	jowq
堚	jpaf
毂	jpam
壝	jpbm
埞	jpg
垨	jpgy
㲄	jphm
埪	jpjl
豰	jpjm
垸	jpjq
塜	jpjs
墶	jpju
㘾	jpkg
塇	jpkk
坾	jpkl
螜	jpkl
彀	jpkm
觳	jpkm
嗀	jpkm
榖	jpkm
殼	jpkm
瑴	jpkm
瞉	jpkm
穀	jpkm
糓	jpkm
縠	jpkm
轂	jpkm
鷇	jpkm
嗀	jpkm
䐨	jpkm
㝅	jpkm
㷤	jpkm
㺉	jpkm
㲉	jpkm
䍍	jpkm
㜌	jpkm
壸	jpkn
壼	jpkn
懿	jpkp
愨	jpkp
㦤	jpkp
鷧	jpkq
㱅	jpkq
壹	jpku
皼	jpkv
亄	jpkx
𡎚	jpmf
壳	jpmg
坈	jpmg
殻	jpmm
悫	jpmp
慤	jpmp
覟	jpmq
壶	jpnu
壷	jpnu
壺	jpnu
㚄	jpnv
塓	jpnw
埦	jpqc
売	jpqg
㙀	jpqt
槖	jpsd
塚	jpse
蠧	jpsl
堗	jpsu
㙆	jpsx
垯	jpsy
垞	jpta
塳	jpth
㨌	jptm
塠	jptv
志	jpu
坹	jpw
塎	jpwb
堔	jpwd
㚃	jpwu
坨	jpx
壱	jpx
垵	jpxk
坁	jqag
坻	jqay
坸	jqb
堍	jqby
塯	jqcn
圽	jqe
圥	jqg
埆	jqm
坞	jqo
塢	jqo
堋	jqq
垑	jqqy
埳	jqrj
垝	jqsc
㙴	jqsy
均	jqu
鋆	jquw
垉	jqv
埩	jqvl
坎	jqw
䤰	jqw
䲧	jqx
㘬	jqxy
圴	jqy
圳	jr
㘺	jrat
垧	jrb
塊	jrb
堢	jrbd
㙞	jrd
㙫	jrd
埤	jrfg
坿	jrgy
塮	jrgy
堭	jrh
塅	jrhm
堆	jrl
垍	jrm
㙸	jrnu
堄	jrqg
垘	jrsu
墺	jrus
堠	jrvt
㙾	jrwc
墽	jryt
坧	js
坜	jsct
㙇	jse
堐	jsjj
堶	jsjq
垮	jsjx
坯	jsk
埼	jskb
坏	jsl
壥	jsmj
㘵	jsml
埯	jsnx
塬	jsri
㙽	jssn
堧	jssy
垅	jst
壠	jst
壢	jstl
㙩	jsui
㙭	jsuq
坺	jsvy
埉	jsww
塽	jsww
㘪	jta
圫	jtag
耊	jtaj
垎	jtb
塩	jtbm
㙖	jtby
圪	jtcg
孝	jtck
教	jtct
㘯	jtct
圲	jtfg
埵	jtfk
墲	jtfo
埄	jthl
耂	jtii
堹	jtkj
壎	jtko
考	jtkx
㼥	jtky
䀋	jtlm
㠻	jtml
塲	jtne
㙏	jtnt
耇	jtqb
垁	jts
墧	jtsb
耉	jttb
鿍	jttj
垀	jtuk
塖	jtux
垖	jtv
埠	jtvf
坆	jtw
㙮	jtwb
老	jtx
耋	jtxa
㖈	jtxb
䎛	jtxb
㐗	jtxc
䎝	jtxc
耆	jtxn
耈	jtxq
䳓	jtxq
耄	jtxt
㙁	jtxu
䎜	jtxx
圦	jty
埢	juc
報	jucv
墫	judg
壿	judg
瓡	juex
垪	juf
㘰	jufg
垟	juh
幸	juj
坢	juj
堘	juj
㼬	juky
增	jumn
墹	jun
𫮃	junf
増	junn
㙂	juq
漐	juqi
墊	juqj
蟄	juql
䠟	juql
贄	juqm
䲀	juqo
慹	juqp
褺	juqq
鷙	juqq
壛	juqr
摯	juqt
騺	juqv
䥍	juqw
縶	juqx
執	juqy
謺	juqy
㙿	juta
㙚	jutl
盩	jutm
墡	juub
塧	juwm
塿	juxk
𪣻	juxk
赱	juy
专	jv
垊	jvag
㙔	jvbt
壀	jvby
㘧	jvc
㙣	jvha
埭	jvio
㙌	jvir
墀	jvit
翿	jvjc
墛	jvjg
壽	jvjg
燾	jvjo
㦞	jvjp
魗	jvjr
圮	jvk
墱	jvku
垏	jvl
壗	jvlm
堳	jvm
䡰	jvma
毊	jvmb
㲈	jvmb
㯏	jvmd
聲	jvmh
漀	jvmi
埇	jvmj
堀	jvmm
馨	jvmn
㷫	jvmo
㿦	jvmr
磬	jvms
罄	jvmt
撀	jvmt
䅽	jvmt
㲇	jvmu
殸	jvmv
鏧	jvmw
㲆	jvmw
謦	jvmy
韾	jvmy
圯	jvp
埽	jvpm
埐	jvpv
垠	jvq
壻	jvq
㘲	jvqt
坲	jvr
声	jvt
塀	jvuf
坡	jvv
墢	jvvm
㙍	jvvv
块	jvwg
坭	jvx
㘮	jvy
走	jw
䞪	jwae
越	jwax
䞖	jway
垥	jwb
趮	jwbd
趗	jwbl
郝	jwc
超	jwcb
趐	jwcc
垺	jwck
坋	jwco
趯	jwcr
赲	jwct
赧	jwcv
埰	jwd
䞕	jwds
䞧	jweb
赾	jwek
䞺	jwem
䞾	jwem
䞣	jwey
䟈	jwfh
赶	jwfl
趞	jwfn
䟌	jwfr
䟒	jwfr
䞚	jwfv
趪	jwfw
䞽	jwfx
䞗	jwgt
埒	jwgy
埓	jwgy
䟄	jwhm
趣	jwhv
䞝	jwhy
趟	jwib
趙	jwiq
赻	jwit
坴	jwj
趌	jwjb
䞸	jwjb
勎	jwjc
勢	jwjc
槷	jwjd
䞨	jwjj
龳	jwjj
䞑	jwjl
䞇	jwjm
䟎	jwjm
赭	jwjn
暬	jwjn
熱	jwjo
燅	jwjo
鵱	jwjq
趬	jwjs
摰	jwjt
驇	jwjv
赫	jwjw
䞰	jwjw
㙯	jwjx
埶	jwjy
䞛	jwkc
趚	jwki
䞓	jwkj
䞙	jwkm
趔	jwkn
趰	jwkw
赨	jwl
趈	jwlb
趠	jwlf
赴	jwlg
赪	jwlm
赬	jwlm
䟊	jwls
䞒	jwmb
䞴	jwmb
趓	jwmd
埨	jwmf
趄	jwmh
䟉	jwml
趉	jwmm
䚂	jwmq
赸	jwmx
墦	jwn
墖	jwnb
䞶	jwne
趕	jwnf
䟆	jwnj
䞡	jwnk
趧	jwnl
䟂	jwnv
趩	jwnw
趒	jwoq
坽	jwp
趤	jwps
鼀	jwpx
赿	jwqa
䞤	jwqb
趂	jwqi
堬	jwqn
趍	jwqq
赹	jwqu
趜	jwqu
趋	jwqv
赩	jwqv
赥	jwqw
赼	jwqw
趨	jwqx
趆	jwqy
䟋	jwqy
赤	jwr
圿	jwr
䞹	jwrh
塪	jwrj
趡	jwrl
䞟	jwrn
趭	jwro
䟍	jwry
䞠	jws
䞜	jwsl
䟐	jwsl
䞥	jwsq
頳	jwsw
䞲	jwta
趫	jwtb
䞦	jwtb
䞬	jwtc
䞘	jwtc
趎	jwti
螫	jwtl
䞢	jwtl
趱	jwtm
趏	jwtm
趲	jwtm
趀	jwtt
赦	jwtw
夌	jwtw
趃	jwtw
趦	jwub
趥	jwud
﨣	jwuf
䟀	jwuj
趑	jwuq
䞫	jwvb
䞻	jwvc
趢	jwvh
起	jwvk
䞷	jwvm
䞞	jwvr
趘	jwvt
䞔	jwvt
赮	jwvv
䞵	jwvv
赽	jwvw
趛	jww
嗇	jwwb
﨏	jwwb
䞱	jwwb
䞩	jwwb
䞯	jwwc
趁	jwwe
䟑	jwwf
龪	jwwg
趖	jwwj
趝	jwwp
䘮	jwwq
㱇	jwwq
䞮	jwwt
赺	jwwv
赵	jwwy
𫭢	jwx
塕	jwxc
䟏	jwxd
䟁	jwxd
䟃	jwxe
赳	jwxl
䞼	jwxs
堫	jwxt
䞭	jwxt
䟇	jwxw
赯	jwyb
䞳	jwyb
埝	jwyp
趇	jwyu
坅	jwyv
圠	jx
坮	jxb
唟	jxbx
却	jxc
刧	jxco
䂲	jxcs
劫	jxct
叝	jxcv
刼	jxcy
弆	jxf
凷	jxl
䖔	jxlm
盍	jxmn
䫦	jxms
刦	jxng
朅	jxnw
鼁	jxpx
㰦	jxqw
堖	jxrw
毐	jxs
堟	jxse
䪺	jxsw
埃	jxts
坶	jxu
埈	jxwt
㘩	jxx
坳	jxxc
㘭	jxxc
墋	jxxe
㙄	jxxj
堦	jxxr
塡	jxxw
㙨	jxxw
去	jxy
壪	jxyv
圡	jy
培	jyb
塙	jybb
埻	jybc
墎	jybc
㙵	jybj
壇	jybk
壤	jybq
壕	jybs
墩	jybt
壈	jybt
坊	jyc
鿾	jyc
垶	jyf
墇	jyfg
墌	jyfo
壙	jyfw
坟	jyg
墒	jymb
墑	jymf
坑	jymg
壞	jymq
堷	jyn
墥	jynj
㙻	jynj
塝	jypy
㙟	jyq
境	jyqg
圹	jys
垃	jyu
埌	jyv
塘	jyvb
垿	jyvc
𡐓	jyvi
墉	jyvl
埣	jywf
壌	jywq
㙥	jywq
塆	jywv
垴	jywx
塶	jyx
堉	jyxq
㙲	jyxr
垓	jyxw
一	k
㦱	kaj
弐	kajg
武	kall
虣	kalm
䝾	kalm
鹉	kalq
鵡	kalq
貮	kamw
勅	kbic
整	kbil
赖	kbim
賴	kbim
剌	kbin
䱫	kbio
慗	kbip
欶	kbiq
鵣	kbiq
鶒	kbiq
鷘	kbiq
頼	kbis
敕	kbit
揧	kbit
㩽	kbiv
束	kbiw
辢	kbiy
橐	kbld
櫜	kbld
㰆	kbld
㯻	kbld
㯱	kbld
蠹	kbll
蟗	kbll
䝴	kblm
囊	kblq
嚢	kblq
栆	kblu
叓	kblv
翮	kbmc
䣓	kbmc
鬴	kbmd
鬺	kbme
鞷	kbmf
融	kbml
鬸	kbmn
䰝	kbmn
鷊	kbmq
鹝	kbmq
鬷	kbmt
鬲	kbmu
䰙	kbmv
䰛	kbmy
䰚	kbmy
畐	kbnb
副	kbnn
疈	kbnn
㽬	kbnn
鶝	kbnq
豌	kbuc
郖	kbuc
㐙	kbuc
鿲	kbuc
豍	kbuf
㪷	kbuf
䜹	kbui
豇	kbuj
豆	kbuk
䜻	kbul
剅	kbun
䝀	kbun
䜽	kbun
䜺	kbun
䝃	kbuo
㰯	kbuq
頭	kbus
毭	kbut
䜶	kbut
䜸	kbut
豏	kbuu
豉	kbuv
䜵	kbuv
䝄	kbuv
䜷	kbuv
䜴	kbuv
䜳	kbux
䜾	kbuy
事	kbvl
剚	kbvn
㐁	kbwg
吏	kbwy
趸	kcbl
劢	kcct
虿	kcl
万	kct
末	kd
膥	kdaw
唜	kdbx
开	kf
邢	kfc
䍾	kfcc
形	kfe
㼛	kfky
㿼	kfmn
䵤	kfmo
䙹	kfmq
刑	kfng
型	kfnj
烎	kfow
㰢	kfqw
鳽	kfqx
雃	kfrl
于	kg
邘	kgc
盂	kgmn
㪀	kgtw
㝳	kiw
夀	kkvg
丁	kl
丅	kl
可	klb
戨	klba
㢦	klba
哥	klbb
㐓	klbc
㪼	klbe
歌	klbq
㰤	klbq
㪃	klbv
邒	klc
乤	klcg
㐉	klcg
下	klg
靕	klhq
㒫	kljq
㠪	klk
鄢	klkc
焉	klko
㼗	klky
正	kll
颪	klml
忑	klpu
鴊	klqx
夒	klrt
顶	klsw
頙	klsw
頂	klsw
政	kltw
亙	klvk
丐	klx
丏	klxc
曹	kmfn
㼑	kmie
棘	kmii
棗	kmii
刺	kmin
鶫	kmiq
敇	kmit
枣	kmiu
㪝	kmiv
柬	kmiw
僰	kmiw
朿	kmiw
再	kmj
巿	kml
帀	kml
両	kmmx
鳾	kmqx
䴓	kmqx
㔝	kmtc
䪣	kmtk
兩	kmty
䪟	kmvk
邴	kmwc
丙	kmwg
㶮	kmwo
㪅	kmwv
两	kmww
郦	kmyc
酈	kmyc
彨	kmye
彲	kmye
鹂	kmyq
鸝	kmyq
䚕	kmyq
婯	kmyx
丽	kmyy
麗	kmyy
畱	knan
㪽	knek
専	kngy
琧	knhy
㯥	knii
鶇	kniq
䰤	knir
東	kniw
㼯	kniy
垩	knj
堊	knj
亘	knk
卝	knk
芈	knkj
畺	knkk
㐀	knkk
刯	knkn
茍	knkq
雈	knkr
蝁	knl
羋	knlj
晋	knn
曺	knn
戬	knna
鄑	knnc
恶	knpu
恵	knpu
悪	knpu
惡	knpu
㰳	knqw
鵶	knqx
严	knt
䴡	kntx
亚	knu
亜	knu
亞	knu
郠	knwc
㬲	knwm
甦	knwt
更	knwy
画	knxl
㓰	knxn
叀	knxy
灭	kow
歹	kq
殘	kqaa
残	kqat
殫	kqbf
殒	kqbm
殞	kqbm
殨	kqbm
㱮	kqbm
殛	kqck
㤪	kqcp
㱤	kqde
歽	kqek
㱠	kqfb
殜	kqfd
殣	kqfh
殱	kqfk
殖	kqfm
殢	kqfm
㱵	kqfm
殑	kqfq
㱩	kqfs
殏	kqgy
㱴	kqhm
殝	kqht
㱶	kqje
殰	kqjm
㱥	kqjt
殪	kqju
殐	kqki
㱫	kqki
殌	kqkj
殭	kqkk
㱛	kqkq
殩	kqku
㱙	kqkx
㱜	kqll
㱺	kqlm
殂	kqmh
殃	kqms
殬	kqmu
㱯	kqmu
殁	kqmv
劽	kqnc
列	kqng
䶛	kqnl
殟	kqnm
㡂	kqnm
㽝	kqnn
烈	kqno
烮	kqno
鮤	kqno
㤠	kqnp
裂	kqnq
鴷	kqnq
㱬	kqnq
䴕	kqnq
銐	kqnw
鿞	kqnw
姴	kqnx
㱧	kqpc
㱨	kqpg
殯	kqpm
殡	kqpw
殥	kqpw
㱰	kqpy
㱚	kqq
歾	kqqe
殉	kqqn
殙	kqqn
歿	kqqv
殦	kqqx
㱱	kqrb
㱷	kqrd
㱭	kqrm
殠	kqrs
㱦	kqsb
㱹	kqsl
殎	kqsw
殗	kqsx
殇	kqte
殤	kqte
歼	kqtf
殅	kqth
殊	kqti
殈	kqtm
㱡	kqtq
殀	kqts
殚	kquf
㱲	kqum
殔	kqvi
肂	kqvl
㱪	kqvn
㱟	kqvv
䬸	kqvw
㱸	kqvy
殍	kqwc
殄	kqwe
殓	kqwi
殲	kqwk
飱	kqwv
餮	kqww
殮	kqww
㱣	kqwx
死	kqx
殆	kqxb
㱝	kqxc
㘸	kqxj
㰷	kqxq
殕	kqyb
殧	kqys
㱞	kqyu
㱢	kqyv
㱻	kqyy
卅	kr
丌	kr
吞	ksb
郉	ksfc
栞	ksfd
幵	ksfl
沗	ksio
忝	ksiw
蝅	kskl
蠺	kskl
蚕	ksl
䗞	ksll
䘉	ksll
䵡	ksmo
昋	ksn
䨿	ksnf
䪞	ksnk
奣	ksnq
㪪	ksnv
㤁	kspu
鴌	ksqx
无	ksx
天	ksy
丣	ktav
来	kud
平	kuk
㼞	kuky
赉	kumw
郏	kusc
刾	kusn
慭	kusp
颊	kuss
頬	kuss
夹	kusy
亊	kuvl
五	kv
吾	kvb
郚	kvbc
㐚	kvbc
敔	kvbt
㐏	kvcg
郪	kvlc
疌	kvll
鶈	kvlq
妻	kvlx
㼮	kvly
忢	kvpu
戸	kvt
夷	kvwg
鴺	kvwq
壐	kwmj
蠒	kwml
覼	kwmq
鸍	kwmq
爾	kwmw
璽	kwmy
丈	kwy
与	kx
丂	kx
瓰	kxcc
邷	kxcc
瓧	kxcf
瓩	kxcf
瓼	kxcj
甅	kxcj
瓸	kxcn
瓱	kxct
瓪	kxcv
瓲	kxcx
瓦	kxcy
坙	kxj
勁	kxjc
䣆	kxjc
巠	kxjl
剄	kxjn
鵛	kxjq
巰	kxjr
頸	kxjs
互	kxk
㔿	kxl
欤	kxqw
攷	kxtw
屯	kxx
戩	kxxa
邨	kxxc
㼊	kxxe
旾	kxxn
晉	kxxn
顿	kxxs
頓	kxxs
上	l
䖗	laab
虐	laak
䗃	laat
蜮	labk
鸆	labq
虞	labs
虏	lact
虨	lade
虗	laek
螹	laek
蛼	laf
䖱	lah
虍	laii
𬟽	laiw
蛭	laj
戲	laka
䖉	lakg
齾	lakl
覻	lakq
㱆	lakq
獻	laks
鬳	laku
䖒	laku
蝛	lakx
甗	laky
蚜	lal
䗩	lali
虥	lama
䣜	lamc
彪	lame
虝	lame
甝	lamf
虎	lamg
虘	lamh
䬌	laml
虤	lamm
虪	lamm
贙	lamm
䖕	lamm
䖑	lamn
䖜	lamn
䖌	lamn
䖖	lamn
覤	lamq
覰	lamq
䖚	lamq
皻	lamv
㪥	lamv
䖋	lamw
䖛	lamx
䖘	lamy
戯	lana
戱	lana
勴	lanc
虜	lanc
㔧	lanc
盧	lanm
慮	lanp
觑	lanq
歔	lanq
膚	lanq
覷	lanq
鸕	lanq
顱	lans
虚	lanu
虛	lanu
㪭	lanv
虡	lanw
蝘	lanx
虙	lapt
虑	lapu
䱷	laqt
䲣	laqt
䖏	laqy
雐	larl
虧	larx
勮	lasc
豦	lase
劇	lasn
頥	lasw
蛲	lasx
蠮	latc
處	latm
歑	latq
虖	latu
䖍	latw
蚷	lav
䖈	lax
虔	layg
㓺	layn
蟈	lbak
蛔	lbb
蟬	lbbf
䗭	lbbp
蝈	lbhy
蜈	lbks
蚛	lbl
蜗	lbmw
蜖	lbnj
蝇	lbnx
蜎	lbq
蜠	lbtd
蛁	lcb
蛡	lcc
蛠	lccc
虸	lck
虵	lcl
凹	lclk
兕	lclq
蜢	lcmn
虭	lco
蠗	lcrl
蜓	lctj
蜒	lctl
蟉	lcwe
蚞	ld
蜥	ldek
䗚	ldgy
䗎	ldj
螵	ldji
蟫	ldnf
蟪	ldpu
蠕	ldsm
蜅	ldu
蜙	ldwx
丯	le
䖣	lei
蚯	lek
蚚	lek
螔	lelm
䖰	leq
䗥	lewl
蛌	lex
蚸	ley
蛄	lfb
螼	lfbh
蠸	lfbr
䗋	lfd
蟖	lfek
蠂	lffd
蟦	lffm
蜞	lfh
蚶	lfj
螨	lfkw
虷	lfl
蠴	lfmj
蝧	lfms
蜹	lfmw
蠛	lfmy
蟎	lfmy
蜡	lfn
䘂	lfnk
蟆	lfns
蟥	lfnw
䗶	lfnw
蠇	lfny
蝾	lfpd
䗖	lfpm
蠓	lfps
蝴	lfq
螮	lfqm
蠘	lfrl
蠖	lfrv
蟒	lfsf
蠎	lfsf
蝻	lfu
蟏	lfvr
蠨	lfvr
蚑	lfvy
蝶	lfxd
卜	lg
占	lgb
战	lgba
鹹	lgbb
㔽	lgbb
梷	lgbd
㮚	lgbd
㣌	lgbe
鹾	lgbj
鹺	lgbj
䴚	lgbm
㓠	lgbn
点	lgbo
鹵	lgbo
㤐	lgbp
觇	lgbq
覘	lgbq
䚃	lgbq
䴛	lgbq
䴜	lgbr
䴞	lgbr
奌	lgbs
頕	lgbs
鹻	lgbu
卣	lgbv
敁	lgbv
鹶	lgbv
䴝	lgbv
卤	lgbw
鹷	lgbw
鹸	lgbw
鹼	lgbw
乩	lgbx
禼	lgbx
卥	lgby
上	lgk
尗	lgki
卡	lgkl
䶶	lgkl
督	lgkm
㫖	lgkn
忐	lgkp
惄	lgkp
裻	lgkq
叔	lgkv
敊	lgkv
仧	lgkw
錖	lgkw
卨	lgmb
盀	lgmn
欳	lgmq
鼑	lgmv
㕟	lgmv
贞	lgmw
貞	lgmw
㦸	lgna
桌	lgnd
卓	lgnf
㲃	lgnm
鵫	lgnq
㪕	lgnv
蛷	lgoy
䜭	lgpb
壑	lgpj
壡	lgpj
䪥	lgpk
睿	lgpm
㲊	lgpm
肻	lgpq
敹	lgpt
叡	lgpv
㕢	lgpv
㕡	lgpv
㪫	lgpv
㣓	lgqe
韰	lgqk
䝳	lgqm
䱗	lgqo
粲	lgqu
餐	lgqw
鳪	lgqx
㛑	lgqx
歺	lgqy
鸬	lgvq
颅	lgvs
卢	lgvt
攴	lgvy
䖞	lgy
蚟	lh
䗅	lha
蟶	lhbh
蜯	lhjl
蚌	lhl
蝽	lhn
蜻	lhq
螓	lhtd
螦	lhx
蝳	lhxu
虫	li
蟝	liad
丨	liii
亅	liii
螳	lij
蝋	limj
蟐	liml
蟷	linb
蛸	liq
䖢	lit
蛣	ljb
蟢	ljbb
蟛	ljbe
蛙	ljj
蟯	ljjs
虹	ljl
蝫	ljn
蚖	ljqg
蚨	ljwg
䗀	ljwt
蛯	ljx
蜐	ljxc
䖼	ljxc
䗘	ljxm
螧	ljxn
丄	lk
蚵	lkb
蝠	lkbn
蝲	lkbn
螎	lkbu
蚈	lkf
虶	lkg
虰	lkl
虾	lklg
凸	lklk
䗡	lklo
螬	lkmn
蛃	lkmw
蜽	lkmy
䖹	lknf
蛚	lkng
蝀	lkni
蝆	lknj
䗵	lknk
蚲	lkuk
蛱	lkus
蜨	lkvl
蛦	lkvw
蛵	lkxj
止	ll
䖵	ll
翽	llac
歳	llai
劌	llan
顪	llas
歲	llat
歫	llav
蛅	llb
歬	lleu
歧	llfv
虲	llg
歵	llhm
颦	llif
顰	llif
龰	llii
频	llis
頻	llis
步	llit
歩	llit
歭	lljg
㱒	llkb
蟲	lll
歨	llll
歮	llll
蠱	lllm
䗂	llmg
蠦	llnm
肯	llq
㱑	llqy
䧳	llrl
㱗	llrs
頉	llsw
歱	lltj
辪	llty
齢	lluw
歯	llux
㱕	llvm
㱓	llwp
此	llx
呰	llxb
啙	llxb
柴	llxd
㭰	llxi
些	llxj
祡	llxj
㘹	llxj
𫚖	llxk
䖪	llxl
赀	llxm
眥	llxm
貲	llxm
㠿	llxm
㫮	llxn
鮆	llxo
觜	llxq
蟕	llxq
鴜	llxq
䳄	llxq
㰣	llxq
㱔	llxq
雌	llxr
砦	llxs
㧘	llxt
胔	llxw
鈭	llxw
飺	llxw
紫	llxx
姕	llxx
訾	llxy
歶	llxy
㱖	llyf
蛐	lmfk
虮	lmg
凣	lmg
蛆	lmh
蚺	lmj
䘃	lmj
蜩	lmjb
蚦	lmjg
蝐	lmjm
蠌	lmju
蠉	lmkq
螘	lmku
䖦	lmm
蠷	lmmr
蠼	lmmv
蠳	lmmx
蛊	lmn
蟔	lmo
螖	lmp
蚬	lmqg
蜆	lmqg
蠋	lmql
蠵	lmrb
蝄	lmuy
蝸	lmvb
蛽	lmw
蚋	lmwg
蛧	lmww
蚒	lmy
䖠	lmy
旧	ln
蚎	ln
蜾	lnd
䖧	lnk
蝪	lnke
蝭	lnkl
蛳	lnkm
蝹	lnmn
蟃	lnmv
䗉	lnn
蠝	lnnn
蝿	lnnx
蚰	lno
䖬	lnp
蝟	lnq
蜴	lnqe
児	lnqg
蠍	lnqq
蝎	lnqw
䗌	lnth
䗱	lnuh
螺	lnx
䗾	lnxo
蜫	lnxx
䗑	lnyu
蟧	looc
蠑	lood
䗊	loow
䖴	loqg
螲	lpaj
蝊	lpg
螛	lphb
䘆	lphp
䖾	lpjq
蟽	lpju
蝖	lpkk
蠙	lpkm
螾	lpkw
蝙	lpmf
螟	lpnw
䗏	lpov
䗿	lppk
蜿	lpqc
䗯	lprl
蜧	lpsu
䖩	lpt
䖳	lpta
䗦	lpth
䗢	lptj
䗆	lpv
螁	lpvq
蛇	lpx
蠅	lpx
蚏	lq
蚔	lqag
蚳	lqay
蚼	lqb
蟓	lqbs
䗜	lqcn
蠏	lqct
蟂	lqd
䗓	lqep
蝜	lqmw
䖲	lqn
蜔	lqnb
螐	lqo
䗨	lqow
蛥	lqqy
蜭	lqrj
蛫	lqsc
蟾	lqsy
蜪	lqtm
蚐	lqu
䗇	lqud
蚫	lqv
㰩	lqw
䳋	lqx
虳	lqy
蜵	lr
蟘	lram
蚮	lray
螝	lrb
䖮	lrb
蝂	lrev
蜱	lrfg
蚹	lrgy
蝗	lrh
蜼	lrl
螩	lrld
䗛	lrlq
蟭	lrow
螅	lrpu
蜺	lrqg
螑	lrsu
蟌	lrtp
蛜	lrvt
䗔	lrvt
螋	lrvy
螕	lrwx
䖨	ls
蝒	lsbj
蚅	lsc
蛖	lse
䖶	lse
䘈	lsfc
蠣	lsfy
蜄	lsj
蝰	lsjj
蚽	lsk
䗁	lskb
蛎	lskc
蟵	lskg
蛨	lsn
蛕	lsq
螈	lsri
蝡	lssy
蠬	lst
蟟	lsui
蟩	lsuq
蛂	lsvy
蝢	lsw
蛺	lsww
䗮	lsww
蚘	lsx
蚝	lta
虴	ltag
蛾	ltat
蜘	ltb
蛒	ltb
蝺	ltby
虼	ltcg
蜏	ltcp
䗴	ltct
蟱	ltfo
﨡	lth
蜂	lthl
蛛	ltiw
䗗	ltkf
蝩	ltkj
䗼	ltko
蚱	ltlg
蛞	ltm
䘊	ltmy
蟍	ltnd
蜊	ltng
蝮	ltnt
蟜	ltsb
蝌	ltuf
䗻	ltvc
蜁	ltvl
螄	ltvm
蛈	ltwg
蜲	ltxk
蜷	luc
蝤	ludk
蛢	luf
蚪	lufg
蛘	luh
蝉	lunf
䗒	lunu
蜕	luq
蠀	luqm
䗲	luqt
蟻	luta
螏	luts
蟮	luub
螊	luw
螠	luwm
蜣	lux
蝼	luxk
螻	luxk
䗹	luxp
螆	luxx
蚂	lv
螞	lv
蝍	lvc
䖡	lvf
蜛	lvfb
蠾	lvil
蜬	lvix
蛏	lvj
蟳	lvjg
蝦	lvjv
䗳	lvku
蚓	lvl
蟰	lvlr
蝞	lvm
蛹	lvmj
蚆	lvn
蛝	lvq
蝑	lvq
蝚	lvtd
蚾	lvv
蝃	lvvv
蟤	lvvw
蚗	lvwg
蚭	lvx
蚇	lvy
齿	lw
䶢	lwab
齖	lwal
䶙	lwav
蛤	lwb
齫	lwbd
龊	lwbl
齪	lwbl
蛻	lwbq
䶫	lwbt
齞	lwbw
齶	lwbx
龆	lwcb
齠	lwcb
蜉	lwck
䶔	lwcl
蚡	lwco
齽	lwdj
齼	lwdv
𬺓	lwdv
齭	lwee
齗	lwek
龂	lwek
䶞	lwfh
䖫	lwfl
齰	lwfn
䶪	lwfr
齻	lwfw
齛	lwfx
蛶	lwgy
䶦	lwhm
齱	lwhv
齒	lwii
䶧	lwjs
龉	lwkb
齬	lwkb
䶗	lwkb
蝯	lwkv
䶚	lwl
䶥	lwlm
龇	lwlx
齜	lwlx
蜦	lwmf
龃	lwmh
齟	lwmh
䶡	lwmn
䶤	lwmp
䶣	lwmu
蟠	lwn
齥	lwnt
齵	lwny
蛉	lwp
齳	lwpa
蟋	lwpu
齣	lwqb
蝓	lwqn
䶟	lwqr
龅	lwqv
齙	lwqv
齺	lwqx
蚧	lwr
齨	lwrj
齯	lwrq
𫠜	lwrq
齮	lwsb
𬺈	lwsb
䖷	lwsm
䶝	lwsw
蜍	lwt
齕	lwtc
龁	lwtc
䶜	lwtj
齚	lwtl
蟡	lwto
龋	lwty
齲	lwty
齸	lwum
龌	lwva
齷	lwva
䶕	lwvn
龈	lwvq
齦	lwvq
䗄	lwwe
䘋	lwwk
龄	lwwp
齡	lwwp
齘	lwwr
𬹼	lwwr
䶖	lwwv
䶨	lwww
蚥	lwwy
龀	lwx
齓	lwx
齔	lwx
齝	lwxb
螉	lwxc
螇	lwxs
蝬	lwxt
蚣	lwxy
蛿	lwyb
螥	lwyb
齴	lwye
䶩	lwyr
䶘	lwyu
蚙	lwyv
齩	lwyw
蠄	lwyx
虬	lx
蠟	lxbx
虯	lxl
䗰	lxmw
蝝	lxse
蛑	lxtl
蚍	lxx
蚴	lxxc
蜌	lxxj
蝔	lxxr
蟣	lxxw
䘎	lxyv
虻	lya
蟙	lyat
蜳	lybc
蝏	lybk
蟺	lybk
蠰	lybq
蠔	lybs
螂	lyc
蚄	lyc
蠐	lycr
䗫	lydd
蟑	lyfg
蟅	lyfo
蚊	lyg
蛀	lyh
蠩	lyjn
䗈	lym
螪	lymb
蚢	lymg
蟀	lyof
䗷	lypu
螃	lypy
蛴	lyr
蝣	lytc
蠊	lyuw
蝷	lyux
蜋	lyv
螗	lyvb
䗧	lyvi
䗤	lyvl
蜶	lywf
蛟	lyww
螭	lywx
蚁	lywy
螰	lyx
蜟	lyxq
䖻	lyxr
蚿	lyxx
同	m
瞘	mabb
䀙	maco
䁪	maek
䁥	mafb
眶	mah
眰	maj
䁍	makb
䁮	maqn
㷡	mavo
眍	mawy
眓	max
冋	mb
矂	mbbd
瞣	mbbp
睏	mbd
睈	mbh
䁒	mbhd
瞆	mblm
瞶	mblm
䁚	mbm
睊	mbq
眖	mbqg
眧	mcb
䁅	mcmn
矅	mcrl
䀽	mctl
睷	mcvl
䀔	mcy
䁣	mdgy
瞟	mdji
瞫	mdnf
矐	mdrl
䀯	mdu
睞	mdww
䁏	mdxk
䀐	me
瞃	mefm
䀪	meg
盺	mek
矀	memt
眽	meq
眅	mevy
瞛	mewl
冊	mf
睵	mfb
䀦	mfb
矔	mfbr
䁧	mfbw
瞸	mffd
㻃	mfhy
曲	mfk
鄷	mfkc
瞱	mfkj
豑	mfkt
豊	mfku
艶	mfkv
瞒	mfkw
盰	mfl
矒	mfmm
䁐	mfms
瞋	mfmw
瞞	mfmy
䁾	mfmy
瞄	mfnb
刪	mfng
瞙	mfns
矇	mfps
㤟	mfpu
矆	mfrv
睰	mfsb
䁳	mfsf
農	mfsj
典	mfw
䀧	mfw
覥	mfwq
觍	mfwq
䐌	mfwq
敟	mfwt
䁋	mfxd
几	mg
䢳	mgc
朵	mgd
凩	mgd
剁	mgdn
䀿	mgek
䁀	mgek
凨	mgjx
凬	mgkn
夙	mgkq
鳳	mgkq
㓘	mgky
凪	mgll
凧	mgml
䥚	mgmw
㶡	mgow
鳯	mgqx
凰	mgrh
凮	mgsn
颬	mgta
颭	mgtb
颱	mgtb
䫿	mgtb
䬘	mgtb
䬏	mgtb
䬅	mgtc
䫸	mgtc
䬀	mgtc
颩	mgte
颺	mgte
飂	mgte
䬞	mgtg
䬖	mgth
飉	mgti
飃	mgtj
䫹	mgtj
䬛	mgtj
䬄	mgtk
䬎	mgtk
風	mgtl
颾	mgtl
飍	mgtl
䬕	mgtl
颲	mgtn
飀	mgtn
飅	mgtn
䫻	mgtn
䬟	mgtn
䬆	mgtn
䬔	mgtn
颷	mgto
飈	mgto
颸	mgtp
䬍	mgtp
颮	mgtq
颵	mgtq
䬑	mgtq
飇	mgts
颳	mgtt
颹	mgtt
飋	mgtt
䬙	mgtt
䬋	mgtt
䫽	mgtt
䫾	mgtt
䬈	mgtu
颴	mgtv
颼	mgtv
䬒	mgtv
䬚	mgtv
颫	mgtw
颶	mgtw
䫼	mgtw
䬉	mgtw
䬊	mgtw
䬝	mgtw
䬐	mgtx
䬂	mgtx
䬁	mgtx
䬜	mgtx
颰	mgty
䬃	mgty
䬓	mgty
凲	mguw
凤	mgvy
飐	mgwb
飏	mgwe
飗	mgwn
飚	mgwo
飔	mgwp
飑	mgwq
飕	mgwv
飓	mgww
风	mgwy
凡	mgy
且	mh
䢸	mhc
助	mhct
眲	mhd
懸	mhip
縣	mhix
盽	mhl
瞔	mhmw
睶	mhn
刞	mhng
睛	mhq
䁃	mhq
鴡	mhqx
雎	mhrl
䪶	mhsw
具	mhw
䡞	mhwa
㮂	mhwd
䋰	mhwx
悬	mhxp
县	mhxy
目	mi
冈	miii
冂	miii
罓	miii
瞠	mij
矘	mimo
睄	miq
眇	mit
用	mj
周	mjb
瞦	mjbb
翢	mjbc
郮	mjbc
彫	mjbe
冔	mjbg
㓮	mjbn
鵰	mjbq
雕	mjbr
䎃	mjcc
冃	mjg
冄	mjg
眎	mji
冉	mjii
眛	mjiw
眭	mjj
䁱	mjjs
冒	mjm
勖	mjmc
㒻	mjmq
毷	mjmt
㪞	mjmv
睹	mjn
冐	mjq
盶	mjqg
冕	mjqq
䁰	mjsw
䶲	mjtp
㒽	mjuc
䁄	mjuj
睦	mjwj
瞡	mjwq
睖	mjwt
甩	mjx
䀷	mjxc
瞌	mjxm
眃	mjxy
㒾	mjyc
㒿	mjyr
同	mkb
戙	mkba
㢥	mkba
䀳	mkbi
㖯	mkbx
眜	mkd
䀘	mkf
盱	mkg
盯	mkl
眄	mklc
眐	mkll
眪	mkmw
矖	mkmy
䀖	mksy
睐	mkud
睫	mkvl
眱	mkvw
䀎	mkx
䀴	mkxj
盹	mkxx
巾	ml
帴	mlaa
䀡	mlb
幧	mlbd
幝	mlbf
幗	mlbk
帜	mlbw
帼	mlby
㠷	mlcy
㠴	mlcy
幖	mldj
㠼	mlek
㡒	mlem
㡗	mlem
幉	mlfd
帺	mlfh
幩	mlfm
㡚	mlfm
㡛	mlfr
幙	mlfs
幪	mlfs
㡕	mlfs
幭	mlfy
帐	mlha
帳	mlha
帱	mlhg
帻	mlhm
幘	mlhm
㡇	mlhx
帩	mliq
幥	mlit
㠺	mlit
帏	mljc
幬	mljg
甴	mljg
幊	mljm
帾	mljn
㠸	mljw
円	mlk
帓	mlkd
帄	mlkl
幅	mlkn
㡟	mlkn
㼙	mlky
帖	mllb
帧	mllm
幀	mllm
㥈	mllp
䁦	mlmh
帽	mlmm
㡌	mlmq
帆	mlmy
㡢	mlnc
幜	mlni
矑	mlnm
幌	mlns
幞	mlnu
㡤	mlnu
幔	mlnv
幆	mlnw
㡓	mlpa
帵	mlpc
㡝	mlph
㡦	mlpm
幰	mlpp
帎	mlpq
幏	mlps
㡧	mlpu
幎	mlpw
㡜	mlqj
㡄	mlqn
㡈	mlqq
㡅	mlqq
㡊	mlqr
幨	mlqy
帷	mlrl
帕	mlrn
幒	mlrp
帿	mlrt
㡙	mlrx
㡡	mlsg
帪	mlsj
帞	mlsn
幁	mlsw
㡋	mlsx
㡁	mlsx
帗	mlsy
幯	mltc
帲	mltf
㡖	mltj
㠶	mltm
幠	mlto
㠽	mltu
帙	mltw
㒳	mlty
帡	mluf
幱	mlui
㡐	mlun
帨	mluq
㡘	mluw
㡞	mlux
幄	mlva
幈	mlvf
帊	mlvn
幃	mlvt
㡠	mlvu
帔	mlvv
㡉	mlvx
帢	mlwb
帉	mlwc
㡨	mlwk
幡	mlwn
㡏	mlwn
㡥	mlwp
幍	mlwr
㠹	mlwr
㡪	mlwt
眦	mlx
㠲	mlx
幓	mlxe
㡎	mlxe
㡃	mlxr
幟	mlya
幛	mlyf
幮	mlyg
幢	mlyj
㡆	mlyr
䶓	mlyr
帹	mlyx
出	mm
䀠	mm
䢺	mmc
㔘	mmct
䁸	mmfs
睓	mmfw
䁼	mmj
睭	mmjb
祟	mmji
䳳	mmjq
㱁	mmjq
㞊	mmjs
䁺	mmju
䄐	mmjv
册	mmk
眮	mmkb
删	mmkn
䁵	mmkq
䁗	mmku
䖓	mmlm
瞐	mmm
䂂	mmmr
䂄	mmmv
䁲	mmmw
䁫	mmo
煛	mmow
瞾	mmpj
鷪	mmpq
愳	mmpu
睍	mmqg
𪾢	mmqg
欪	mmqw
戵	mmra
䣤	mmrc
𨟠	mmrc
瞿	mmrl
鸜	mmrq
氍	mmrt
矍	mmrv
瞁	mmsu
䪼	mmsw
眏	mmsy
粜	mmud
糶	mmur
四	mn
罭	mnak
䍓	mnal
䍛	mnbf
罥	mnbq
䍒	mnd
罧	mndd
䍣	mndn
罛	mnex
罟	mnfb
羇	mnfb
睅	mnfl
䍐	mnfl
置	mnfm
羃	mnfm
罱	mnfu
羁	mnfv
羈	mnfv
刚	mng
皿	mnii
罒	mnii
䍝	mnin
眔	mnio
䳴	mniq
㱎	mniq
䁜	mnis
罣	mnjj
罫	mnjl
署	mnjn
罴	mnjo
㸃	mnjo
歝	mnjq
瞏	mnjq
鸅	mnjq
斁	mnjt
睪	mnju
罢	mnjx
䍏	mnk
翾	mnkc
䁑	mnke
罡	mnkl
睼	mnkl
㓻	mnkn
睘	mnkq
鹮	mnkq
䴉	mnkq
睤	mnkr
䀻	mnkx
眒	mnl
罩	mnlf
罝	mnmh
鷶	mnmq
䚑	mnmq
奰	mnms
買	mnmw
罪	mnnf
罼	mnnj
罳	mnnp
罹	mnor
䁙	mnpx
䁌	mnq
睗	mnqe
斣	mnqf
㝶	mnqg
蜀	mnql
劅	mnqn
罶	mnqn
歜	mnqq
鸀	mnqq
䫳	mnqs
斀	mnqv
䍖	mnqv
罗	mnqy
䍕	mnqy
䍜	mnrl
眾	mnrw
罘	mnsl
䍥	mnsl
罽	mnsn
罨	mnsx
䍔	mnsx
睲	mnth
䍢	mnto
䍙	mntx
䍘	mnud
瞨	mnuh
罾	mnun
罤	mnut
罵	mnv
罠	mnva
罻	mnvg
罞	mnvt
罬	mnvv
罦	mnwc
䍟	mnwt
罖	mnwy
㔥	mnxc
罺	mnxd
羄	mnxf
羆	mnxo
羂	mnxq
羅	mnxr
鿡	mnxw
罷	mnxx
羉	mnxx
詈	mny
罸	mnyg
罜	mnyh
罿	mnyj
罚	mnyn
罯	mnyn
罰	mnyn
䍦	mnyr
䍤	mnyr
䍚	mnyv
䍡	mnyx
䍠	mnyx
䍗	mnyx
黑	mo
黬	moab
黖	moaq
黓	moay
䵲	mobd
黫	modj
黚	mofj
䵟	mofl
黩	mofs
黰	mofw
黮	mofx
䵦	moig
䵬	moin
墨	moj
黠	mojb
䵱	mojb
䵢	moji
黷	mojm
䵭	mojn
黗	mokx
點	molb
黸	molm
黜	momm
䵮	mone
䵞	mong
䵣	monk
䵪	monx
睒	moow
黦	mopc
黕	mopq
䵴	mopx
眺	moqg
黟	moqq
䵥	moqv
㱄	moqw
黵	moqy
䵠	moqy
䵨	mose
䁿	mosm
默	mosu
黤	mosx
䵰	mote
䵯	motj
黣	motx
黭	mowf
䵳	mown
黔	mowv
䵝	mox
黝	moxc
黪	moxe
黲	moxe
黢	moxt
黥	moyi
黯	moyn
骨	mp
睴	mpaf
骮	mpay
䯣	mpbm
髎	mpce
䯇	mpct
䯕	mpct
髆	mpdg
骵	mpdk
䯙	mpdu
骺	mpeb
䯒	mpeg
骷	mpfb
髒	mpff
骭	mpfl
䯦	mpfy
瞎	mphb
䯑	mpis
䯓	mpjj
睆	mpjq
䯈	mpjq
髐	mpjs
䯊	mpkb
骬	mpkg
睻	mpkk
眝	mpkl
矉	mpkm
瞚	mpkw
骾	mpkw
髗	mplm
骴	mplx
䯞	mpmb
髑	mpml
體	mpmu
骰	mpmv
䯐	mpmw
骪	mpmy
髁	mpnd
䯜	mpne
䯠	mpnm
䯥	mpno
瞑	mpnw
髃	mpny
䯔	mppa
䯛	mppc
矃	mppk
髕	mppm
髓	mppq
髋	mppq
髄	mppq
䯘	mppq
髉	mppr
髂	mppt
髌	mppw
髖	mppy
睕	mpqc
眈	mpqg
骩	mpqt
骲	mpqv
䯉	mpqw
鹘	mpqx
鶻	mpqx
骶	mpqy
骫	mpqy
髀	mprf
䯝	mpsq
睙	mpsu
顝	mpsw
骻	mpsx
䯋	mpsy
䀣	mpt
骼	mptb
䯏	mptm
瞇	mpud
骿	mpuf
髊	mpuj
䯟	mpus
䯡	mpuw
髅	mpux
髏	mpux
䯌	mpvq
骳	mpvv
䯎	mpwf
䯤	mpwn
䯍	mpwp
骱	mpwr
骽	mpwx
䯆	mpx
䯗	mpxj
䯚	mpxq
髇	mpyb
髍	mpyd
骯	mpym
䯖	mpyv
骸	mpyw
骹	mpyw
髈	mpyy
眀	mq
眂	mqag
睧	mqan
眡	mqay
眗	mqb
眳	mqb
睌	mqbq
䂁	mqby
䀚	mqc
覎	mqck
觃	mqck
䀛	mqe
覹	mqet
见	mqg
見	mqg
䙷	mqgy
䙸	mqgy
䀥	mqiw
覞	mqmq
矎	mqmt
眴	mqn
䁩	mqow
眵	mqqy
瞻	mqsy
盷	mqu
睁	mqvl
覐	mqww
瞗	mqx
䀓	mqy
䁛	mrb
睥	mrfg
睢	mrl
瞧	mrow
矈	mrpy
矏	mrpy
睨	mrqg
睺	mrvt
瞍	mrvy
䁶	mryt
郹	msc
矋	msfy
䀼	msj
睚	msjj
睳	msjj
㼜	msky
盎	msmn
䁆	msnx
䒋	msqv
鸯	msqx
鴦	msqx
鶪	msqx
䴗	msqx
䁭	msss
眬	mst
矓	mst
鿃	msty
狊	msu
瞭	msui
㿮	msvv
䀹	msww
央	msy
眊	mta
睋	mtat
䀩	mtb
盵	mtcg
䀒	mtfg
睡	mtfk
瞴	mtfo
䀱	mthl
矄	mtko
䀨	mtm
矁	mtop
瞅	mtow
眨	mtp
䀢	mts
眣	mtwg
䀲	mtxu
內	mty
睠	muc
眯	mud
䀞	mufg
眻	muh
瞤	muh
眫	muj
䁟	mujl
剛	mumn
䁬	mumn
岡	mumx
瞷	mun
瞯	muq
瞵	muqt
眹	musy
䂀	muta
睇	muvt
矙	muvt
䁠	muw
䁡	muwg
瞜	muxk
䁖	muxk
㒺	muxw
罔	muya
眠	mvag
䁕	mvan
䁹	mvby
睩	mvh
瞰	mvht
殳	mvii
矚	mvil
睱	mvjv
睽	mvks
瞪	mvku
䀕	mvl
冎	mvm
睸	mvm
咼	mvmb
剮	mvmn
旤	mvmq
歄	mvmq
䫚	mvms
囘	mvp
眼	mvq
䀟	mvr
瞲	mvtb
瞩	mvty
䀗	mvwg
眤	mvx
䀑	mvy
䁊	mvym
贝	mw
賤	mwaa
贓	mwaa
蠈	mwal
贼	mwas
賊	mwas
贱	mwat
戝	mwat
賎	mwat
䞃	mwat
䞁	mwax
冏	mwb
䀫	mwb
㕯	mwb
賗	mwbl
贃	mwbp
贶	mwbq
貺	mwbq
瞼	mwbw
郥	mwc
䁯	mwcc
賿	mwce
貤	mwcl
盼	mwco
睬	mwd
贉	mwdf
赙	mwdg
賻	mwdg
䝵	mwdu
眕	mwe
贩	mwev
販	mwev
贜	mwfa
賳	mwfb
購	mwfm
赎	mwfs
䝸	mwfv
贎	mwfy
内	mwg
财	mwgt
財	mwgt
赇	mwgy
賕	mwgy
䀬	mwh
账	mwha
賬	mwha
賰	mwhn
䞐	mwhn
䝼	mwhq
䞍	mwhq
貝	mwii
睑	mwik
贘	mwim
䞆	mwim
䝰	mwjg
贖	mwjm
赌	mwjn
賭	mwjn
貦	mwjq
赋	mwkl
賦	mwkl
䁔	mwkv
㒷	mwkw
盻	mwkx
贴	mwlb
貼	mwlb
䞊	mwlm
賙	mwmb
赒	mwmb
睔	mwmf
䂃	mwmg
賵	mwmm
贔	mwmm
赑	mwmm
赗	mwmm
瞺	mwmn
鹦	mwmq
鸎	mwmq
鸚	mwmq
䴍	mwmq
䨉	mwmr
罂	mwmt
罌	mwmt
贁	mwmt
賏	mwmw
賟	mwmw
鑍	mwmw
婴	mwmx
嬰	mwmx
甖	mwmy
譻	mwmy
赐	mwne
賜	mwne
则	mwng
則	mwng
䞎	mwnn
䞏	mwnp
贌	mwnu
赕	mwoo
賧	mwoo
賱	mwpa
䝹	mwpc
賝	mwpd
賩	mwpj
贮	mwpk
貯	mwpk
瞬	mwpt
瞹	mwpt
䝭	mwqb
賯	mwqc
睮	mwqn
䝧	mwqu
购	mwqx
鵙	mwqx
赡	mwqy
貾	mwqy
贍	mwqy
䞀	mwrt
䞅	mwsb
赈	mwsj
賑	mwsj
䝽	mwsj
睎	mwsm
贿	mwsq
賄	mwsq
贆	mwss
䞂	mwss
贚	mwst
㲘	mwta
赂	mwtb
賂	mwtb
䝯	mwtc
貹	mwth
䝫	mwtl
賉	mwtm
䞌	mwtm
䁘	mwtm
贬	mwtp
貶	mwtp
败	mwtw
敗	mwtw
賆	mwuf
賹	mwum
䞉	mwum
赠	mwun
贈	mwun
赚	mwuw
賺	mwuw
䝻	mwvf
睜	mwvl
䝪	mwvl
贐	mwvm
赆	mwvu
䝲	mwvu
貱	mwvv
賶	mwwb
䀰	mwwb
䝩	mwwe
䍑	mwwf
肉	mwwg
赊	mwwj
睉	mwwj
賒	mwwj
䍞	mwwk
羀	mwwn
䞈	mwwo
賖	mwwt
网	mwwy
贻	mwxb
貽	mwxb
瞈	mwxc
贂	mwxe
賐	mwxt
䁓	mwxt
赔	mwyb
賠	mwyb
賥	mwyf
䝬	mwyh
䝶	mwyi
赃	mwyj
賍	mwyj
貥	mwym
䞋	mwyq
赅	mwyw
賅	mwyw
賋	mwyw
䝮	mwyx
賘	mwyy
山	mx
㟞	mxaa
嵅	mxab
嶇	mxab
峫	mxac
峸	mxac
崭	mxae
嶃	mxae
嶄	mxae
岽	mxai
峌	mxaj
岈	mxal
嶜	mxan
峣	mxas
嵗	mxat
岠	mxav
岖	mxaw
崴	mxax
㞽	mxax
眙	mxb
嶯	mxba
嵓	mxbb
崮	mxbf
崓	mxbf
㠆	mxbf
㟕	mxbf
㞲	mxbl
岲	mxbq
嶉	mxbr
巖	mxbt
巗	mxbt
崿	mxbx
䁽	mxbx
㞻	mxbx
㟧	mxbx
㠋	mxbx
邖	mxc
岧	mxcb
岹	mxcb
㟃	mxcb
嵺	mxce
㞨	mxck
屶	mxco
屷	mxcp
㞧	mxcp
嶍	mxcr
㠕	mxcr
㠄	mxcr
屴	mxct
嶐	mxct
岌	mxcy
屻	mxcy
岃	mxcy
岋	mxcy
嶘	mxda
崊	mxdd
㟳	mxdd
㠨	mxdg
嵀	mxdh
㟽	mxdj
嵖	mxdk
㠒	mxdn
嶿	mxds
峬	mxdu
崍	mxdw
崧	mxdx
崾	mxdx
嶀	mxdx
㟣	mxdx
崻	mxeg
岓	mxek
岴	mxek
嵷	mxel
嵸	mxel
嶽	mxes
嶶	mxet
㠅	mxet
岅	mxev
嵂	mxev
岵	mxfb
崂	mxfc
㟑	mxfc
嵘	mxfd
㟿	mxff
㠏	mxfj
屽	mxfl
嵽	mxfm
𫶇	mxfm
㟙	mxfn
嵌	mxfq
㠌	mxfq
嶻	mxfr
巏	mxfr
巅	mxfs
巔	mxfs
㠓	mxfs
𪩘	mxfs
巈	mxfu
岐	mxfv
㟟	mxfv
㠛	mxfv
嵮	mxfw
嶱	mxfw
㟷	mxfw
嵁	mxfx
㟐	mxfy
㟛	mxgf
嶊	mxgr
㟈	mxgy
㟹	mxhc
㟖	mxhf
崝	mxhq
㟼	mxht
㠂	mxht
㠦	mxhu
巀	mxia
埊	mxij
崉	mxin
汖	mxio
峭	mxiq
巌	mxit
県	mxiw
峙	mxjg
亗	mxjg
崶	mxjg
嶹	mxjg
屸	mxjl
㞬	mxjl
㠝	mxjm
岏	mxjq
崁	mxjq
嶢	mxjs
嶤	mxjs
崚	mxjt
㞿	mxjw
峔	mxjx
岢	mxkb
峿	mxkb
㞹	mxkb
岍	mxkf
崠	mxki
崬	mxki
崋	mxkj
峘	mxkk
崨	mxkl
颽	mxkl
凱	mxkm
嶆	mxkn
剴	mxkn
峛	mxkn
峢	mxkn
覬	mxkq
峡	mxks
嵿	mxks
獃	mxks
顗	mxks
巎	mxkt
敳	mxkt
崃	mxku
岼	mxku
豈	mxku
敱	mxkv
峓	mxkw
峺	mxkw
屿	mxkx
㼘	mxky
巇	mxla
岾	mxlb
峠	mxll
㠠	mxlm
㠊	mxln
巘	mxls
巚	mxls
岗	mxm
峒	mxmb
峝	mxmb
㟘	mxmb
𪨰	mxmf
㞦	mxmg
岨	mxmh
嵐	mxml
㟵	mxml
崗	mxmm
㟠	mxmm
崱	mxmn
嶵	mxmn
㠑	mxmn
岘	mxmq
峴	mxmq
岟	mxms
嶩	mxms
㟨	mxms
嵦	mxmu
嶧	mxmu
岚	mxmw
屾	mxmx
岀	mxmx
巊	mxmx
㞩	mxmy
㞱	mxn
崵	mxne
嵵	mxng
㠚	mxng
㠥	mxnj
崼	mxnl
岫	mxno
峀	mxno
崽	mxnp
岬	mxnp
嵔	mxnq
㟪	mxnq
嶪	mxnu
嶫	mxnu
岿	mxnv
嵑	mxnw
崐	mxnx
崑	mxnx
嵎	mxny
巆	mxob
嶗	mxoc
嶸	mxod
嵴	mxoq
㞫	mxp
㟦	mxpa
嵱	mxpb
崇	mxpj
崆	mxpj
㓽	mxpn
㟮	mxps
㟉	mxpt
㟯	mxpt
岤	mxpw
㟰	mxpw
岮	mxpx
峖	mxpx
峵	mxpx
岄	mxq
㞴	mxqa
岣	mxqb
峁	mxqc
岇	mxqc
峗	mxqc
峞	mxqc
翙	mxqc
䣙	mxqc
嵥	mxqd
岉	mxqe
峥	mxql
崅	mxqm
峋	mxqn
刿	mxqn
剻	mxqn
崏	mxqn
嵧	mxqn
嵨	mxqo
崩	mxqq
嶑	mxqs
嶰	mxqt
㰞	mxqw
嶋	mxqx
嶌	mxqx
岁	mxqy
岻	mxqy
嶦	mxqy
巉	mxqy
㞮	mxqy
嵬	mxrb
巂	mxrb
㟴	mxrb
嶲	mxrc
酅	mxrc
嵲	mxrd
㠍	mxrd
㠎	mxrd
崥	mxrf
㟸	mxrf
㟆	mxrf
崲	mxrh
㟫	mxri
崔	mxrl
矊	mxrm
岶	mxrn
㔒	mxrn
嶕	mxro
嶣	mxro
䳽	mxrq
㠢	mxrq
㠗	mxrs
峳	mxrt
㟬	mxrv
嶼	mxrw
㠘	mxrw
岩	mxs
屵	mxs
輋	mxsa
𪨶	mxsa
崎	mxsb
㟢	mxsb
𫵷	mxsc
㟌	mxse
岸	mxsf
㟁	mxsf
嶚	mxsi
嶛	mxsi
㟲	mxsi
㟶	mxsi
崖	mxsj
峚	mxsj
崕	mxsj
嶳	mxsj
岯	mxsk
㞸	mxsl
㠣	mxsl
峏	mxsm
耑	mxsm
剬	mxsn
炭	mxso
峟	mxsq
嶡	mxsq
嶥	mxsq
歂	mxsq
䳪	mxsq
嵟	mxsr
颛	mxss
顓	mxss
巃	mxst
巄	mxst
鼎	mxsv
嶏	mxsv
䵻	mxsv
㪜	mxsv
峽	mxsw
崸	mxsw
崦	mxsx
屼	mxsx
巁	mxsy
㼷	mxsy
峨	mxta
峩	mxta
峈	mxtb
峉	mxtb
嶠	mxtb
㠐	mxtb
屹	mxtc
嵙	mxtf
峰	mxth
峯	mxth
峼	mxtj
崜	mxtk
㞰	mxtk
眸	mxtl
岝	mxtl
岞	mxtl
巋	mxtm
巑	mxtm
峲	mxtn
巍	mxtr
峤	mxtr
岆	mxts
䀵	mxts
㞺	mxts
嵊	mxtu
峂	mxtu
㠟	mxtw
崣	mxtx
嶭	mxty
㞥	mxty
嶬	mxua
㠖	mxua
㟡	mxuc
崷	mxud
㞳	mxuf
嶟	mxug
㠈	mxuh
㟄	mxuh
嵯	mxuj
嵳	mxuj
嶒	mxun
㟱	mxuo
㟋	mxuq
嵄	mxus
嶙	mxut
巙	mxut
嵰	mxuw
嵝	mxux
嵫	mxux
嶁	mxux
巕	mxux
㟺	mxux
岷	mxva
峮	mxvb
㟒	mxvb
崌	mxvf
嶎	mxvg
㟤	mxvh
峄	mxvj
岂	mxvk
屺	mxvk
峍	mxvl
嵹	mxvl
凯	mxvm
嵋	mxvm
崛	mxvm
崫	mxvm
剀	mxvn
岜	mxvn
㟭	mxvn
觊	mxvq
峎	mxvq
㟜	mxvq
岪	mxvr
𫖮	mxvs
嶝	mxvu
嵶	mxvu
岥	mxvv
崡	mxvx
㞾	mxvx
㠔	mxvy
崟	mxw
崯	mxw
峪	mxwb
峆	mxwb
峇	mxwb
嵢	mxwb
㟏	mxwb
㟔	mxwb
岎	mxwc
嵡	mxwc
嶖	mxwc
㟊	mxwc
崘	mxwf
崙	mxwf
㞤	mxwg
峑	mxwh
崄	mxwi
㟇	mxwj
峜	mxwl
崢	mxwl
㟓	mxwm
嵛	mxwn
崳	mxwn
嶓	mxwn
岭	mxwp
岺	mxwp
嶾	mxwp
崤	mxwq
嵚	mxwq
嶔	mxwq
䳥	mxwq
㟅	mxwq
岕	mxwr
嵠	mxws
嶺	mxws
䫈	mxws
睃	mxwt
嵏	mxwt
嵕	mxwt
岑	mxwv
岒	mxwv
嵈	mxwv
嶮	mxww
㟎	mxwx
乢	mxx
䀝	mxx
岰	mxxc
眑	mxxc
䁻	mxxd
嵾	mxxe
㠁	mxxe
㟥	mxxe
峅	mxxf
嶈	mxxg
崰	mxxn
巓	mxxs
峻	mxxt
㟂	mxxu
嶷	mxxv
㠜	mxxv
禸	mxy
訔	mxy
嵩	mxyb
嵜	mxyb
嵣	mxyb
嵪	mxyb
﨑	mxyb
㟝	mxyb
崞	mxyc
崺	mxyc
嵃	mxye
嶂	mxyf
峷	mxyf
崒	mxyf
崪	mxyf
巐	mxyf
㠃	mxyf
㞵	mxyg
㞶	mxyg
嵻	mxyi
㠉	mxyj
嵉	mxyk
䂅	mxyl
㟾	mxyl
崹	mxym
峕	mxyn
㠧	mxyn
㠤	mxyq
㠡	mxyq
㠇	mxys
㠙	mxys
嵼	mxyt
岦	mxyu
崀	mxyv
㟍	mxyv
峐	mxyw
峧	mxyw
嵭	mxyy
丹	my
盳	mya
䁨	mybc
䁁	mybi
䁎	mybk
䁴	mybk
眆	myc
䢷	myc
彤	mye
瞕	myfg
雘	myfv
矌	myfw
䵊	myfw
盿	myg
眿	myio
䁤	mymf
刐	myng
瞳	mynj
鴅	myqx
瞓	myr
䀮	myr
䁢	mytv
䀶	myv
瞊	myvb
睟	mywf
㥖	mywp
瞝	mywx
瞮	myxt
䀭	myxw
眩	myxx
是	n
晟	nac
晠	nac
暱	nafb
晊	naj
晓	nasx
昛	nav
煚	navo
田	nb
㽣	nbak
暺	nbbf
曮	nbbt
嬲	nbcc
疁	nbce
男	nbct
㽖	nbct
㽒	nbct
㽭	nbds
畈	nbev
畖	nbex
異	nbfw
畴	nbhg
畤	nbjg
疇	nbjg
畦	nbjj
畊	nbjr
畉	nbjw
疅	nbkk
町	nbkl
甼	nbkl
畏	nbkq
畀	nbkr
㽯	nbmb
畘	nbmj
畕	nbnb
㔣	nbnc
櫐	nbnd
畼	nbne
壘	nbnj
壨	nbnj
疉	nbnk
疊	nbnm
畾	nbnn
鸓	nbnq
䴑	nbnq
䴎	nbnq
礨	nbns
氎	nbnt
罍	nbnt
㲲	nbnt
㽮	nbnt
纍	nbnx
塁	nboj
疂	nbom
畹	nbpc
畳	nbpm
顋	nbps
思	nbpu
胃	nbq
㽛	nbqb
㫛	nbqg
畇	nbqu
㽤	nbqu
鴫	nbqx
畂	nbqy
甽	nbr
㽡	nbrf
畸	nbsb
盢	nbsm
畎	nbsu
㽠	nbsw
㽢	nbsx
略	nbtb
畧	nbtb
畽	nbtj
㽚	nbtl
㨼	nbtt
畋	nbtw
畮	nbtx
䌎	nbtx
畔	nbuj
畻	nbuj
㽨	nbuj
㽪	nbun
疄	nbut
㽧	nbux
㽥	nbvd
㙒	nbvj
畷	nbvv
畛	nbwe
㽟	nbwg
㽗	nbwg
界	nbwr
畍	nbwr
畟	nbwt
畭	nbwt
累	nbx
㽩	nbxe
㚻	nbxk
㽙	nbxq
畯	nbxt
毗	nbxx
毘	nbxx
甿	nbya
疃	nbyj
㽘	nbym
畩	nbyq
畡	nbyw
昭	ncb
照	ncbo
旸	nce
㫗	nck
旫	nco
曜	ncrl
㫑	nct
毾	ncta
㬔	ncwe
昅	ncy
果	nd
杲	nd
晽	ndd
晰	ndek
晒	ndg
暷	ndgy
㬍	ndgy
㬓	ndji
曇	ndjx
㼫	ndky
敤	ndlv
曋	ndnf
褁	ndq
夥	ndqq
曤	ndrl
曘	ndsm
颗	ndsw
顆	ndsw
㪙	ndtw
晡	ndu
㬡	ndwp
昕	nek
㫹	neve
昄	nevy
暰	newl
暀	neyh
非	nf
㫒	nf
辈	nfaf
輩	nfaf
㬮	nfbr
暵	nfbw
翡	nfcc
㐟	nfcg
棐	nfd
暁	nffs
早	nfg
旪	nfg
㻗	nfhy
畢	nfjl
鷝	nfjq
㪤	nfjt
韭	nfk
曅	nfkj
曄	nfkj
䪤	nfkw
旱	nfl
蜚	nfl
旰	nfl
㪋	nflv
暎	nfms
䩀	nfmw
暪	nfmy
剕	nfng
暯	nfns
曂	nfnw
㫲	nfpc
曚	nfps
悲	nfpu
曔	nfqt
䳚	nfqx
㬦	nfrv
㬒	nfsf
猆	nfsu
䫍	nfsw
奜	nfsy
靟	nfta
㹃	nftl
䩁	nftt
暔	nfu
曣	nfuo
晎	nfw
暴	nfwi
餥	nfwv
㿺	nfwv
謈	nfwy
婓	nfxk
斐	nfyg
裴	nfyq
晣	ngek
刂	ngii
师	ngkm
帅	ngml
监	ngtm
临	ngtn
览	ngtq
㧛	ngtt
鉴	ngtw
䛓	ngty
归	ngvh
坚	ngvj
贤	ngvm
䝨	ngvm
肾	ngvq
紧	ngvx
竖	ngvy
时	ngy
旺	nh
朂	nhct
㬩	nhhp
暳	nhhv
暙	nhn
晴	nhq
最	nhvy
日	ni
曰	niii
㫾	nimb
曭	nimo
晃	nisx
晄	nisx
㬁	niwb
里	nj
圼	nj
暿	njbb
昻	njc
𬀩	njc
㫴	njck
昮	njct
時	njgy
㫭	njgy
昧	njiw
晆	njj
曉	njjs
暑	njn
暏	njn
黒	njow
曀	njpu
黙	njso
野	njvc
墅	njvj
㫙	njwg
㫱	njwr
㬨	njww
昙	njxy
㫢	njxy
旦	nk
曧	nkbl
㬏	nkbu
鼌	nkbx
昩	nkd
旴	nkg
㝵	nkgy
韪	nklj
是	nkll
昰	nkll
㓳	nkln
鶗	nklq
题	nkls
題	nkls
尟	nklt
晸	nklt
韙	nklt
匙	nklx
㼵	nkly
暕	nkmi
昁	nkml
昞	nkmw
昺	nkmw
曬	nkmy
量	nknj
晅	nknk
㬐	nknn
㫫	nknu
鼂	nkpx
㦹	nkqa
昜	nkqe
䬗	nkql
敭	nkqt
鴠	nkqx
昊	nksy
晤	nkvb
㫸	nkvl
旽	nkxx
申	nl
曱	nl
畅	nlce
㫔	nlk
朄	nlki
暢	nlne
晫	nlnf
曥	nlnm
畃	nlqy
㫟	nmb
勗	nmct
㼔	nmex
晪	nmfw
晭	nmjb
曙	nmjn
曎	nmju
晍	nmkb
㬅	nmkc
暟	nmku
愚	nmlp
顒	nmls
颙	nmls
禺	nmly
㼴	nmly
昢	nmm
㬬	nmmr
昷	nmn
㬞	nmnw
晛	nmqg
𬀪	nmqg
曓	nmsk
㬥	nmsu
㬧	nmsx
映	nmsy
鄤	nmvc
曼	nmvy
旵	nmx
曪	nmxr
昌	nn
昍	nn
㫀	nnek
暃	nnf
㫵	nnf
曝	nnfi
晘	nnfl
龧	nnjn
㫜	nnk
暘	nnke
㬈	nnmn
㬂	nnmy
晶	nnn
晿	nnn
曑	nnne
㬪	nnnk
曡	nnnm
曟	nnns
曐	nnnt
焸	nnow
暥	nnpx
晹	nnqe
暍	nnqw
顕	nnsw
㫯	nnsx
暒	nnth
显	nnu
㬣	nnug
曗	nnuh
㫣	nnx
㬤	nnxo
暻	nnyi
由	no
邮	noc
㕀	noc
㷖	nocb
㐕	nocg
暅	nokk
䳙	nokq
畁	nokr
甹	nokx
冑	nomj
晱	noow
胄	noq
晁	noqg
晀	noqg
頔	nosw
𬱖	nosw
䨽	novk
㽕	novx
炅	now
炚	now
甲	np
晕	npaf
晖	npaf
暈	npaf
暉	npaf
翈	npcc
晥	npjq
暄	npkk
暝	npnw
晼	npqc
鸭	npqx
鴨	npqx
曢	npsi
㬖	nptb
㬕	npuh
昈	npv
曃	npvi
晏	npxk
㫨	npxk
鷃	npxq
䨃	npxr
明	nq
㫝	nqay
昫	nqb
㫥	nqb
晚	nqbq
昂	nqc
易	nqe
昒	nqe
剔	nqen
惖	nqep
鶍	nqeq
敡	nqev
琞	nqhy
暩	nqji
盟	nqmn
㬇	nqms
㫬	nqn
晩	nqnq
煦	nqow
焽	nqow
曌	nqpj
䳟	nqqx
㿢	nqrn
㬗	nqso
㦔	nqsp
猒	nqsu
曕	nqsy
旯	nqt
昴	nqtc
曻	nqtj
昀	nqu
㬠	nqvo
欥	nqw
㔠	nqxc
㓭	nqxn
歇	nqxq
鶡	nqxq
鹖	nqxq
䫘	nqxs
毼	nqxt
曷	nqxw
旳	nqy
晌	nrb
晑	nrb
暞	nrd
㫿	nrl
暭	nrof
曍	nrof
晲	nrqg
暤	nrsf
㬋	nrvt
晔	nrxf
曒	nryt
曞	nsfy
晨	nsj
㬄	nsjw
晇	nsjx
晻	nsnx
鷐	nsqx
昦	nsr
㬉	nssy
昽	nst
曨	nst
暸	nsui
暊	nsw
昃	nswg
㫕	nsx
旲	nsy
戥	ntat
㫓	ntcg
昇	ntf
星	nth
甠	nth
晧	ntj
旿	ntk
曛	ntko
晷	ntlb
昨	ntlg
㫼	ntmn
昸	ntu
㫡	ntu
暣	ntud
昳	ntwg
晦	ntxu
业	nu
邺	nuc
㫧	nud
斲	nuek
㫠	nuj
暛	nujl
㬝	numn
㓸	nung
暽	nuqt
㽔	nust
曦	nuta
㬢	nuta
鄴	nuuc
黺	nuuc
黼	nuud
對	nuug
業	nuuh
菐	nuuh
黹	nuui
丵	nuuj
懟	nuup
鸈	nuuq
㱉	nuuq
䴆	nuuq
㲫	nuut
糳	nuuu
叢	nuuv
鑿	nuuw
凿	nuux
黻	nuuy
彂	nuvt
晜	nuvt
㬆	nvan
暐	nvbt
㫽	nvh
曯	nvil
暇	nvjv
暌	nvks
㬘	nvlr
㫶	nvpm
昲	nvr
曊	nvrm
昵	nvx
㬛	nwcc
昐	nwco
昣	nwe
㬰	nwg
暖	nwkv
㬊	nwkv
㫻	nwmf
㬭	nwmg
昤	nwp
曖	nwpt
暧	nwpv
晞	nwsm
暚	nwtm
㬙	nwto
暡	nwxc
昖	nwxy
晗	nwyb
昑	nwyv
电	nx
㫐	nx
㬃	nxbo
昪	nxf
妟	nxk
䳛	nxqx
曳	nxt
曵	nxty
㫞	nxvy
晙	nxwt
昆	nxx
㬎	nxxo
歞	nxxq
鵾	nxxq
鹍	nxxq
顯	nxxs
曏	nxyc
暠	nybb
䯫	nybb
㬑	nybc
㬀	nybc
影	nybe
景	nybi
晾	nybi
㔀	nybn
曩	nybq
颢	nybs
顥	nybs
暾	nybt
㬯	nyby
昉	nyc
昘	nyc
暲	nyfg
曠	nyfw
旻	nyg
旼	nyg
昹	nyio
㫤	nyio
暗	nyn
㬌	nyni
曈	nynj
旷	nys
暆	nytc
暶	nytv
昱	nyu
㫰	nyv
昗	nyw
晬	nywf
晈	nyww
㬚	nyxt
晐	nyxw
昡	nyxx
昿	nyxy
快	o
㥇	oaat
慪	oabb
惐	oabk
惭	oaek
慚	oaek
悈	oaf
㥾	oafb
恇	oah
恎	oaj
恜	oajl
㦐	oajm
憾	oakp
惬	oaks
㤉	oal
慽	oali
㥱	oanf
愝	oanx
憯	oaqn
愜	oasw
懢	oatm
怇	oav
慳	oavj
怄	oawy
怴	oax
㤜	oay
慖	obak
恛	obb
懆	obbd
憚	obbf
愕	obbx
㦍	obbx
悃	obd
悜	obh
悮	obks
忡	obl
愦	oblm
憒	oblm
㥙	oblp
愪	obm
悁	obq
怳	obqg
㥵	obse
悒	obvn
怾	obw
慍	obwm
悞	obxs
怊	ocb
㥛	ocbk
恊	occc
愶	occq
忆	ocg
忚	ocl
忉	oco
慴	ocrn
憜	ocsq
忇	oct
㦕	octt
憀	ocwe
㦩	ocwp
忣	ocy
㣼	ocy
㦭	odbw
惏	odd
慄	odd
㦗	oddj
憷	oddv
恓	odg
愽	odgy
慱	odgy
慓	odji
㤓	odk
憛	odnf
憓	odpu
懦	odsm
悑	odu
憟	odud
怵	ody
懫	oeem
㤚	oeg
忻	oek
㤧	oekb
㥴	oelm
惞	oeqw
㤆	oevy
怙	ofb
懄	ofbc
慬	ofbh
懽	ofbr
愅	off
愤	offm
憤	offm
㥍	ofh
㤌	ofj
㦊	ofkj
忓	ofl
㥀	ofmh
懵	ofmm
懜	ofmq
愥	ofms
慎	ofmw
慲	ofmy
懱	ofmy
惜	ofn
愺	ofnf
懴	ofnk
慔	ofns
悖	ofpc
懞	ofps
懥	ofpv
㦅	ofqm
憽	ofqp
㦜	ofrv
懂	oftj
忮	ofvy
㤨	ofw
怈	ofx
愖	ofx
惵	ofxd
恾	ofya
慌	ofyr
㤹	ogoy
忖	ogy
忹	oh
怅	oha
悵	oha
㤽	ohgy
懾	ohhh
懳	ohhp
㥭	ohio
㦈	ohmn
㥽	ohmw
情	ohq
慠	ohtw
慑	ohvv
愫	ohx
㤴	ohx
忄	oiii
憆	oij
惝	oimb
戃	oimo
悄	oiq
恍	oisx
悩	oiwx
恄	ojb
懛	ojba
憘	ojbb
憉	ojbe
恃	ojgy
怽	ojiw
㤬	ojj
憢	ojjs
愩	ojmw
㥩	ojn
㦉	ojpu
忨	ojqg
悻	ojuj
懤	ojvg
懎	ojwb
㤸	ojwr
㥄	ojwt
懗	ojww
恅	ojx
恸	ojxc
㤼	ojxc
㥺	ojxm
愭	ojxn
怯	ojxy
忶	ojxy
㥘	ojxy
悚	okbi
懒	okbm
懶	okbm
愊	okbn
㤱	okbu
㤦	okbw
忊	okl
恆	oklk
怔	okll
㥼	oklo
㤄	okml
慒	okmn
怲	okmw
㤡	okng
恒	oknk
悿	oksi
怃	oksx
怦	okuk
悟	okvb
恞	okvw
悽	okvx
忳	okxx
怗	olb
悼	olnf
憈	olnu
懅	olse
㦆	oltu
憹	omfs
㥏	omfw
怚	omh
惆	omjb
懌	omju
恫	omkb
懁	omkq
愷	omku
㤕	omm
懼	ommr
戄	ommv
怬	omn
恻	omng
惻	omng
愲	omp
悓	omqg
慛	omrl
惴	omsm
怏	omsy
惘	omuy
恺	omvk
惧	omw
㤯	omwb
㦬	omxr
忛	omy
㦒	omy
愣	omyc
惈	ond
悱	onf
懪	onfi
悍	onfl
愰	onis
悝	onj
怛	onk
愓	onke
㥂	onkg
惿	onkl
愄	onkq
愠	onmn
㦙	onmp
慢	onmv
㥥	onmy
怞	ono
愢	onpu
㥜	onq
惕	onqe
愒	onqw
惺	onth
㦠	onug
悭	onvj
㤤	onwy
惃	onxx
㥗	onyg
憬	onyi
憦	oooc
惔	ooow
恌	ooqg
㦪	ooyv
恽	opaf
惲	opaf
慩	opaf
㦥	ophp
悰	opji
悾	opjl
愃	opkk
㤖	opkl
惼	opmf
慏	opnw
懧	oppk
惋	opqc
忱	opqg
悷	opsu
怭	opt
㤞	opta
愘	optb
㦀	opth
慥	optj
㤈	opu
悺	opv
愹	opwb
㤾	opwd
憴	opx
忯	oqag
惛	oqan
怟	oqay
怐	oqb
悗	oqbq
懰	oqcn
懈	oqct
惚	oqep
愡	oqep
忰	oqfg
兆	oqg
憏	oqji
鼗	oqjv
覜	oqmq
愌	oqms
恂	oqn
惸	oqnc
㥊	oqq
鴵	oqqx
恀	oqqy
惂	oqrj
恑	oqsc
㦓	oqso
頫	oqsw
𫖯	oqsw
憺	oqsy
㥌	oqud
怉	oqv
㤘	oqvh
忺	oqw
恟	oqwx
㥮	oqxx
㣿	oqy
愧	orb
恦	orb
恘	ord
楽	ord
㤔	orgy
惶	orh
懙	orkw
惟	orl
懏	orlc
怕	orn
憔	orow
㤛	ortj
憁	ortp
懊	orus
愯	orvy
㥰	orvy
㥚	orwg
憿	oryt
㤑	osb
㤳	osb
愐	osbj
㤶	ose
㤒	osfg
墯	osjj
㦋	osjn
惰	osjq
恗	osjx
怌	osk
㥓	oskb
怀	osl
恠	oslj
怖	osml
懮	osmt
懨	osns
㤿	osnx
恢	osow
㤢	osq
㥳	osri
恹	ossu
愞	ossy
憭	osui
㥧	osw
悏	osww
慡	osww
忧	osx
忕	osy
忲	osy
恪	otb
忾	otc
忔	otcg
悸	otck
忏	otfg
憮	otfo
性	oth
悎	otj
忤	otk
慟	otkc
憡	otki
怍	otlg
恬	otm
恤	otmn
慯	otne
悧	otng
愎	otnt
愀	otow
㦫	otqm
㦧	otqn
憍	otsb
㤭	otsr
㤇	otsy
愾	otud
㦢	otvc
怢	otwg
悔	otxu
惓	ouc
㥢	oudk
恲	ouf
怑	ouj
㦨	ouki
慻	oum
憎	oumn
惮	ounf
懻	ounw
㥃	oup
㦖	oupu
悦	ouq
憪	ouq
憐	ouqt
㦦	ourq
㥞	ouse
㤏	out
愱	outs
悌	ouvt
慊	ouw
慺	ouxk
㥪	ouxk
悯	ouyg
憫	ouyg
懩	ouyv
怋	ovag
惽	ovan
慨	ovaq
愇	ovbt
忬	ovc
忸	ovf
㥝	ovhd
㦑	ovht
㥆	ovio
怪	ovj
憳	ovjg
㦎	ovjk
怿	ovjl
忋	ovk
憕	ovku
愑	ovmc
悀	ovmj
恨	ovq
㥠	ovq
怫	ovr
憰	ovtb
愵	ovuu
怶	ovv
惙	ovvv
㦏	ovvw
快	ovwg
怩	ovx
㥡	ovxd
㣾	ovy
慅	ovyl
惤	ovyx
火	ow
惍	ow
烥	owa
熰	owab
煘	owab
㮡	owad
炼	owai
烒	owaj
熞	owaj
爁	owam
熸	owan
爦	owaq
烧	owas
炬	owav
𬉼	owaw
恰	owb
焒	owbb
煰	owbb
燥	owbd
焑	owbd
燀	owbf
烟	owbg
熅	owbm
熉	owbm
煾	owbp
悅	owbq
炾	owbq
焆	owbq
炽	owbw
憸	owbw
㶽	owbw
怆	owc
邩	owc
炤	owcb
㶸	owcc
炀	owce
熮	owce
灺	owcl
烻	owcl
燲	owcm
灱	owco
㤋	owco
熁	owcq
熠	owcr
燿	owcr
烶	owct
煡	owcv
熤	owcy
炑	owd
㥒	owd
爩	owde
燂	owdf
煿	owdg
煙	owdj
熛	owdj
㷑	owdj
㶱	owdk
烞	owdl
㸌	owdr
燸	owds
烳	owdu
燯	owdw
爧	owdw
炢	owdy
烆	oweg
炘	owek
焮	oweq
烐	oweu
炍	owev
灷	owf
㶿	owfc
煤	owfd
煠	owfd
燍	owfe
煂	owff
㷹	owff
爤	owfi
燁	owfj
㶰	owfj
爡	owfl
㶥	owfl
煹	owfm
燌	owfm
焟	owfn
爑	owfo
燪	owfp
煳	owfq
烵	owfq
爟	owfr
煐	owfs
焼	owfs
㷬	owfs
煵	owfu
烘	owfw
烡	owfw
焫	owfw
熯	owfw
熿	owfw
煁	owfx
燤	owfy
恮	owh
㷃	owha
㸎	owhh
炐	owhl
灬	owii
爣	owim
龦	owim
焇	owiq
熦	owir
炒	owit
灶	owj
熺	owjb
炜	owjc
燽	owjg
㶹	owji
烓	owjj
㷯	owjj
灴	owjl
熆	owjm
熕	owjm
㸇	owjm
懚	owjp
燒	owjs
焃	owjw
爀	owjw
烤	owjx
焐	owkb
炣	owkb
㶺	owkb
㶬	owkd
煉	owki
烴	owkj
烜	owkk
灯	owkl
炡	owkl
㸊	owkm
煏	owkn
㷮	owkn
愋	owkv
炳	owkw
炖	owkx
烛	owl
㸍	owla
炶	owlb
焯	owlf
爞	owll
爐	owlm
爈	owlp
㷾	owls
燦	owlu
爘	owlw
炯	owmb
烔	owmb
烱	owmb
煱	owmb
烿	owme
惀	owmf
㷨	owmh
爅	owmj
㶲	owmj
煈	owml
燭	owml
炪	owmm
焵	owmm
懀	owmn
㷵	owmo
焨	owmq
䙺	owmq
熣	owmr
爠	owmr
炴	owms
煓	owms
燶	owms
燡	owmu
炈	owmv
㶧	owmw
灿	owmx
熴	owmx
焹	owmy
憣	own
畑	ownb
㷄	ownd
焬	owne
煬	owne
焊	ownf
焺	ownf
灲	owng
爆	owni
燝	owni
熚	ownj
爗	ownj
㷸	ownj
炟	ownk
煶	ownl
煴	ownm
焻	ownn
燳	owno
炠	ownp
煨	ownq
煟	ownq
熀	owns
煋	ownt
㸁	ownu
熳	ownv
熶	ownv
爜	ownv
熼	ownw
㷎	ownw
焜	ownx
煜	owny
㷒	owny
煔	owob
營	owob
郯	owoc
勞	owoc
䎕	owoc
榮	owod
檾	owod
燊	owod
爃	owod
醟	owod
煢	owof
㷀	owof
滎	owoi
塋	owoj
烾	owoj
禜	owoj
㷥	owok
螢	owol
飊	owol
嵤	owom
焭	owom
䁝	owom
剡	owon
㽦	owon
焱	owoo
熒	owoo
燚	owoo
㷋	owoo
憥	owop
㥕	owop
欻	owoq
歘	owoq
烑	owoq
膋	owoq
褮	owoq
覢	owoq
覮	owoq
鶑	owoq
鶯	owoq
顃	owos
顲	owos
䃕	owos
犖	owot
罃	owot
㲜	owot
㲭	owot
㷠	owot
䝁	owou
敥	owov
炎	owow
炏	owow
鎣	owow
嫈	owox
縈	owox
瑩	owoy
甇	owoy
謍	owoy
䪯	owoy
怜	owp
烢	owpa
煇	owpa
熔	owpb
熍	owpb
煽	owpc
焥	owpc
煸	owpf
熢	owph
爎	owpi
焢	owpj
煊	owpk
熥	owpm
烷	owpq
㶶	owpq
㶩	owpq
燧	owps
㷝	owps
懓	owpt
燵	owpu
炉	owpv
煺	owpv
焪	owpv
熩	owpv
㷟	owpv
㥅	owpv
熐	owpw
炨	owpx
脊	owq
㶯	owqc
䶴	owqf
灮	owqg
烁	owqi
愉	owqn
熘	owqn
焔	owqn
焝	owqn
㶷	owqn
燃	owqo
熓	owqo
龽	owqo
㷓	owqp
焩	owqq
鶺	owqq
鹡	owqq
㶴	owqq
焰	owqr
䰪	owqr
焕	owqs
煥	owqs
㶢	owqt
炮	owqv
炊	owqw
煼	owqx
䲴	owqx
灼	owqy
㶤	owqy
忦	owr
㷪	owrc
烌	owrd
烨	owrf
焷	owrf
煌	owrh
慆	owrj
㷐	owrj
焳	owrl
煅	owrm
燬	owrm
燋	owro
熄	owrp
熜	owrp
燠	owrs
燩	owrt
炛	owrx
炻	ows
㷞	owsc
烼	owse
燎	owsi
㷧	owsi
煃	owsj
炋	owsl
爏	owsl
悕	owsm
烣	owso
烠	owsq
煗	owss
爖	owst
烦	owsw
煩	owsw
恡	owsx
㷈	owsx
炦	owsy
爄	owsy
悇	owt
灹	owta
烙	owtb
燆	owtb
炧	owtc
爋	owtc
㸅	owtc
㷲	owtc
秌	owtd
㷆	owtf
烽	owth
焅	owtj
煄	owtj
炸	owtl
愮	owtm
烅	owtm
㸆	owtn
煍	owto
燻	owto
㷻	owto
烍	owtq
熪	owtq
烀	owtu
炵	owtu
熂	owtu
炇	owtw
烸	owtx
炿	owty
燨	owua
爔	owua
㷽	owub
煪	owud
炓	owuf
𬊤	owuf
燇	owug
烂	owuh
烊	owuh
爛	owui
熷	owun
㷙	owun
焖	owup
燜	owup
燗	owuq
爓	owur
烪	owus
煫	owus
焍	owut
燐	owut
㷣	owut
熌	owuw
熑	owuw
熡	owux
燘	owuy
焗	owvb
燏	owvb
㶦	owvc
煣	owvd
炄	owvf
燖	owvg
𬊈	owvg
烃	owvj
爥	owvl
煀	owvm
煝	owvm
燼	owvm
㷁	owvm
㷌	owvm
炥	owvr
熽	owvr
煒	owvt
烬	owvu
燈	owvu
煆	owvv
炔	owvw
㷷	owvw
焓	owwb
烚	owwb
焀	owwb
熗	owwb
炝	owwc
烰	owwc
熻	owwc
爚	owwf
㷍	owwf
爝	owwg
烇	owwh
懺	owwk
烯	owwm
燔	owwn
燴	owwn
㷔	owwn
炩	owwp
焧	owwp
焾	owwp
炌	owwr
熖	owwr
熎	owwt
燰	owwt
煖	owwv
㷿	owww
烩	owwx
炂	owwx
㤊	owwy
炲	owxb
慃	owxc
㶭	owxc
爍	owxd
㷘	owxd
忷	owxl
恱	owxq
煯	owxr
慀	owxs
惾	owxt
焌	owxt
㶼	owxt
爉	owxx
忪	owxy
熾	owya
焙	owyb
熵	owyb
愴	owyb
煻	owyb
熇	owyb
㤷	owyb
焞	owyc
燺	owyd
焠	owyf
炆	owyg
炷	owyh
燑	owyj
燷	owyj
㸀	owyj
㷚	owyk
炞	owyl
炕	owym
煷	owym
熫	owyo
爊	owyo
爕	owyo
㸉	owyo
惗	owyp
燱	owyp
焴	owyq
爙	owyq
㸄	owyr
㷜	owys
夑	owyt
燉	owyt
燣	owyt
燫	owyu
燮	owyv
忴	owyv
烺	owyv
烄	owyw
烗	owyw
焿	owyw
爌	owyw
炫	owyx
熝	owyx
㷰	owyx
焲	owyy
㽊	owyy
怡	oxb
惯	oxmw
慣	oxmw
恉	oxn
惱	oxrw
惨	oxse
㥟	oxse
恈	oxtl
懝	oxtv
怓	oxvy
悛	oxwt
怮	oxxc
㦡	oxxd
慘	oxxe
悂	oxxj
愼	oxxw
㣺	oy
忙	oya
悋	oyb
㥉	oyb
惇	oybc
悙	oybc
惊	oybi
懔	oybj
憻	oybk
㥫	oybn
懹	oybq
憱	oybs
憞	oybt
懍	oybt
㤃	oyc
懠	oycr
戂	oydn
懡	oydx
慞	oyfg
懭	oyfw
忟	oyg
怺	oyio
惦	oylb
忭	oylg
忼	oymg
懐	oymq
懷	oymq
愔	oyn
憧	oynj
憶	oypu
㥬	oypy
㤺	oyr
㦃	oyst
悢	oyv
慷	oyvi
慵	oyvl
悴	oywf
恔	oyww
恼	oywx
㦇	oyx
慉	oyxn
㥔	oyxq
㤝	oyxq
㤥	oyxw
怰	oyxx
这	p
连	paf
連	paf
䢕	pak
迓	pal
㦁	papu
迴	pbb
遌	pbbx
遻	pbbx
逞	pbh
迚	pbl
遗	pblm
遺	pblm
遣	pblv
逥	pbnj
辽	pc
迢	pcb
迦	pcb
迅	pcfg
逊	pciw
䢊	pck
迆	pcl
辺	pco
辸	pcp
䢰	pcrl
䢫	pcsq
边	pct
遜	pctx
䢧	pcwe
﨤	pcy
䢞	pdd
迺	pdg
逎	pdk
䢮	pdnb
遷	pdsv
逋	pdu
逨	pdww
述	pdy
鶐	pdyq
遁	pefm
逛	peh
逓	pejm
近	pek
逅	pekb
遞	pelm
逖	peow
返	pevy
䢨	pewl
辻	pfg
迀	pfl
遘	pfmj
逪	pfn
邁	pfny
遰	pfqm
逽	pfsb
遖	pfu
遳	pfwj
迣	pfx
䢡	pfxd
定	pg
宦	pga
宧	pga
宬	pgac
室	pgaj
宫	pgbb
宲	pgbd
宮	pgbr
宺	pgbr
㝋	pgc
寥	pgce
字	pgck
㝚	pgcl
㝫	pgct
宋	pgd
㝝	pgdd
寭	pgdp
䫅	pgds
寙	pgee
逝	pgek
宾	pgew
㝒	pgfb
寋	pgfc
寨	pgfd
塞	pgfj
䞿	pgfj
蹇	pgfl
䗙	pgfl
赛	pgfm
賽	pgfm
㝤	pgfm
㝜	pgfn
㥶	pgfp
宽	pgfq
褰	pgfq
寛	pgfq
鶱	pgfq
𬸣	pgfq
寞	pgfs
搴	pgft
寒	pgfu
骞	pgfv
弿	pgfv
騫	pgfv
寘	pgfw
謇	pgfy
寬	pgfy
守	pggy
害	pghb
豁	pghb
寳	pghm
寶	pghm
㲅	pghm
割	pghn
憲	pghp
寈	pghq
鶷	pghq
䴐	pghq
㝣	pghs
寚	pght
寷	pghu
㪡	pghv
㝡	pghv
実	pghw
㝙	pghw
㝬	pghw
宝	pghy
宀	pgii
㲾	pgio
宵	pgiq
寖	pgiv
宯	pgjc
宗	pgji
崈	pgjm
賨	pgjm
完	pgjq
鵍	pgjq
鶎	pgjq
㝨	pgjq
宑	pgjr
寇	pgjv
宼	pgjx
㝪	pgjy
㝉	pgk
戭	pgka
翧	pgkc
䎙	pgkc
宇	pgkg
宣	pgkk
宁	pgkl
寁	pgkl
賓	pgkm
㿾	pgkm
富	pgkn
㝞	pgkn
䚔	pgkq
㝟	pgkq
䳦	pgkq
䨈	pgkr
顮	pgks
㪦	pgkt
寅	pgkw
㝍	pgkx
宐	pglk
寊	pglm
寂	pglv
宂	pgmg
䢇	pgmg
宜	pgmh
寰	pgmq
鴧	pgmq
㝮	pgmv
审	pgnl
寔	pgnl
宙	pgno
䴁	pgnq
䥌	pgnw
㝠	pgnw
宴	pgnx
寓	pgny
宨	pgoq
㝭	pgot
叜	pgov
灾	pgow
逑	pgoy
㝎	pgp
寧	pgpk
蜜	pgpl
寜	pgpl
密	pgpm
甯	pgpm
寍	pgpm
寗	pgpm
䀄	pgpm
䁇	pgpm
鸋	pgpq
宓	pgpt
㲰	pgpt
㝕	pgpv
宛	pgqc
察	pgqj
䗕	pgql
䵫	pgqm
剜	pgqn
惌	pgqp
鵷	pgqq
鹓	pgqq
㝖	pgqq
寏	pgqs
宄	pgqt
寃	pgqy
㝌	pgqy
寯	pgrc
㝦	pgrc
宱	pgrl
寉	pgrl
宿	pgrn
寫	pgro
寑	pgrv
㝛	pgrw
㝰	pgry
宕	pgs
寄	pgsb
寡	pgsc
翝	pgsc
家	pgse
寮	pgsi
宸	pgsj
寕	pgsk
宥	pgsq
宠	pgst
寵	pgst
宊	pgsu
顁	pgsw
宏	pgsx
宅	pgta
宒	pgta
客	pgtb
㝯	pgtb
逰	pgtc
牢	pgtl
愙	pgtp
宪	pgtq
额	pgts
宎	pgts
額	pgts
㝢	pgty
宩	pgud
宻	pgum
实	pgus
寝	pguv
寠	pgux
官	pgv
宭	pgvb
賔	pgvm
悹	pgvp
宆	pgvx
宖	pgvx
㝊	pgvy
㝓	pgwb
㔤	pgwc
宷	pgwd
寀	pgwd
審	pgwn
寪	pgwo
覾	pgwq
㝏	pgwr
它	pgx
寤	pgxb
䢿	pgxc
案	pgxd
寱	pgxd
鞌	pgxf
寐	pgxi
㝧	pgxj
安	pgxk
實	pgxm
䀂	pgxm
㝲	pgxm
鴳	pgxq
䙾	pgxq
㝱	pgxq
頞	pgxs
䅁	pgxt
㝥	pgxu
寢	pgxv
寲	pgxv
寎	pgxw
寣	pgxy
㼠	pgxy
过	pgy
㝘	pgy
㝑	pgyc
宰	pgyf
宔	pgyh
㝩	pgyi
寴	pgyq
㝗	pgyv
宍	pgyw
㝔	pgyw
迋	ph
遨	phtw
之	pi
辶	piii
逤	piit
逍	piq
迼	pjb
遠	pjbq
违	pjc
逇	pjcl
遶	pjjs
䢱	pjmm
远	pjqg
进	pjr
達	pjuh
逹	pjuj
逵	pjwj
迃	pjx
逺	pjxq
运	pjxy
迲	pjxy
辷	pk
速	pkbi
逼	pkbn
遬	pkbq
遫	pkbt
逗	pkbu
迈	pkct
䢎	pkf
迂	pkg
䢥	pklm
迊	pkml
䢌	pkml
遭	pkmn
逦	pkmy
邐	pkmy
迾	pkng
䢝	pknu
䢚	pknw
䢋	pkr
迗	pksy
逜	pkvb
䢩	pkvt
邇	pkww
逕	pkxj
迍	pkxx
迠	plb
逌	plbv
遉	plmw
逴	plnf
遽	plse
迥	pmb
䢗	pmfk
䢐	pmh
遝	pmio
週	pmjb
迵	pmkb
還	pmkq
䢲	pmmv
逻	pmqy
遄	pmsm
過	pmvb
䢙	pmw
䢛	pmwb
辿	pmx
邏	pmxr
遢	pncc
逿	pnke
遈	pnkl
迧	pnl
遇	pnmy
迪	pno
逷	pnqe
遏	pnqw
暹	pnrl
䢠	pof
䢯	poot
逃	poqg
郓	ppac
鄆	ppac
军	ppaf
軍	ppaf
運	ppaf
鶤	ppaq
顐	ppas
皲	ppav
皸	ppav
冧	ppdd
冪	ppfm
䢘	ppgy
冣	pphv
冖	ppii
冠	ppjg
冡	ppjs
冦	ppjv
㓂	ppjx
䢓	ppkg
冨	ppkn
写	ppkx
㓀	pplg
遍	ppmf
冗	ppmg
䢆	ppmg
冝	ppmh
鼏	ppmv
冚	ppmx
鄍	ppnc
幂	ppnm
鼆	ppnp
覭	ppnq
䫤	ppns
䒌	ppnv
冥	ppnw
农	ppq
肎	ppq
邥	ppqc
冘	ppqg
沊	ppqi
㱽	ppqm
鸩	ppqq
鴆	ppqq
䧵	ppqr
䪴	ppqs
冤	ppqy
瓭	ppqy
隺	pprl
冩	ppro
鹤	pprq
鶴	pprq
冟	pprx
冢	ppse
冞	ppud
邃	ppus
逭	ppv
㓁	ppw
罙	ppwd
罕	ppwf
迱	ppx
㓃	ppya
迌	pq
䢑	pqay
逸	pqby
迎	pqc
遛	pqcn
邂	pqct
迩	pqi
迯	pqlg
迿	pqn
迻	pqqy
遯	pqse
遙	pqtm
䢣	pqy
邎	pqyx
逈	prb
遑	prh
進	prl
迫	prn
邉	prpb
邊	prpy
遚	prvy
邀	pryt
逐	pse
逩	psff
遀	psjq
还	psl
迶	psq
迖	psu
遼	psui
达	psy
迏	psy
迄	ptcg
迤	ptcl
透	ptcp
䢤	ptdy
迁	ptfg
逢	pthl
蠭	pthl
䗬	pthl
㷭	ptho
造	ptj
遾	ptjw
迕	ptk
逬	ptkf
迮	ptlg
适	ptm
邍	ptnv
选	ptqg
邌	ptqw
䢪	ptsb
逄	pttj
追	ptv
迭	ptwg
逶	ptxk
込	pty
心	pu
䙁	puaa
䙔	puab
裓	puaf
䙘	puai
䘭	puaj
䙯	pual
襤	puam
䘬	puas
褗	puax
䘝	puay
吢	pub
裍	pubd
襙	pubd
襌	pubf
裀	pubg
裎	pubh
衶	publ
䙌	pubm
䙡	pubm
裐	pubq
䙟	pubt
袑	pucb
衪	pucl
䘰	pucl
初	puco
褶	pucr
䙍	pucu
衱	pucy
迷	pud
遵	pudg
䙏	pudg
襟	pudj
褾	pudj
遒	pudk
襦	puds
襻	pudt
補	pudu
褼	pudv
䙥	pudw
䘴	pudx
䙅	pudx
䘤	pudy
衫	pue
裄	pueg
褷	puel
䙕	puel
褫	puem
䙉	puem
迸	puf
褋	pufd
䢏	pufg
褀	pufh
襽	pufi
衦	pufl
襺	pufl
褠	pufm
䙊	pufm
䙦	pufq
䙮	pufr
䙩	pufs
衼	pufv
褡	pufw
襶	pufw
袣	pufx
襼	pufx
襔	pufy
襪	pufy
衬	pugy
襵	puhh
襀	puhm
𫌀	puhm
裱	puhq
褉	puhs
褝	puif
衤	puii
襠	puin
䘯	puiq
裆	puiv
袺	pujb
鿋	pujb
袆	pujc
袿	pujj
褂	pujl
襩	pujm
褚	pujn
褤	pujq
襓	pujs
襭	pujs
裬	pujt
衭	pujw
袪	pujx
褹	pujy
袔	pukb
袜	pukd
衧	pukg
襋	puki
襰	pukm
褔	pukn
褿	pukn
䙣	pukn
裋	puku
䙐	puku
襧	pukw
褄	pukx
裲	puky
襹	puky
袩	pulb
补	pulg
裃	pull
裭	pulm
褃	pulq
䘣	pulx
裯	pumb
䘛	pumg
袓	pumh
衻	pumj
袡	pumj
襡	puml
䘜	puml
袦	pumm
䙖	pumq
褍	pums
襛	pums
䘧	pums
襗	pumu
衲	pumw
襬	pumx
䙬	pumx
䙓	pumx
袇	pumy
衵	pun
褟	punc
裸	pund
裼	pune
裶	punf
襨	pung
襮	puni
裡	punj
襅	punj
袒	punk
褆	punl
褴	punm
褞	punm
裮	punn
袖	puno
䘥	punp
䙨	punq
襆	punu
襊	punv
褐	punw
裩	punx
裧	puoo
裢	pupa
裈	pupa
褌	pupa
褳	pupa
褣	pupb
䙤	pupb
䘼	pupc
橤	pupd
褊	pupf
䘺	pupg
䙜	puph
䙋	pupk
䘢	pupk
䙭	pupl
惢	pupp
衴	pupq
襚	pups
袐	pupt
褪	pupv
䘾	pupv
袕	pupw
繠	pupx
袉	pupx
衹	puqa
袧	puqb
䘩	puqn
袳	puqq
䙀	puqq
襐	puqs
遴	puqt
裪	puqt
袀	puqu
袍	puqv
袛	puqy
襜	puqy
裫	pur
噵	purb
褓	purd
襍	purd
裨	purf
導	purg
袝	purg
裑	purh
道	purm
袙	purn
䘽	purq
襣	purr
袱	purs
襖	purs
袵	purt
襷	purt
䙈	purt
䆃	purt
襥	puru
㘏	purx
袥	pus
裿	pusb
袸	pusc
遂	puse
褥	pusg
袏	pusj
裖	pusj
袻	pusm
袹	pusn
襫	pusn
㸂	puso
鿪	puso
䙃	pusq
䙠	pusq
䙇	puss
襱	pust
裌	pusw
䘠	pusw
袴	pusx
裺	pusx
送	pusy
袚	pusy
必	put
袼	putb
袘	putc
邲	putc
袮	puti
袾	puti
衽	putj
褈	putj
裇	putm
襸	putm
䙧	putm
覕	putq
鴓	putq
䙄	putr
袄	puts
袶	putt
複	putt
袟	putw
裷	puuc
襕	puui
襴	puui
䘷	puui
袢	puuj
褨	puuj
裥	puun
襇	puun
䙢	puun
褙	puuq
裞	puuq
襉	puuq
䢭	puuq
襒	puut
䙫	puuw
褛	puux
褸	puux
䘞	puv
裙	puvb
褬	puvd
裾	puvf
襑	puvg
䘵	puvh
襁	puvl
䘟	puvl
䙱	puvl
襏	puvm
䘿	puvm
裉	puvq
䙆	puvs
递	puvt
褘	puvt
䙙	puvt
䙞	puvu
被	puvv
裰	puvv
䘲	puvv
袂	puvw
襈	puvw
䘦	puvx
䘶	puvx
衩	puvy
䘳	puw
裕	puwb
袷	puwb
衯	puwc
袗	puwe
裣	puwi
襳	puwk
褕	puwn
襎	puwn
襘	puwn
袊	puwp
䙂	puwp
衸	puwr
䙎	puws
衿	puwv
褑	puwv
襝	puww
衳	puwx
袽	puxb
袎	puxc
襂	puxe
遱	puxk
逆	puxl
遡	puxq
褖	puxs
褦	puxx
袯	puxy
裤	puya
褲	puya
䙗	puyf
䘹	puyf
襢	puyk
褅	puym
褯	puym
䙒	puyn
襯	puyq
䙛	puyq
䘻	puyq
䘪	puyq
䙑	puyq
裗	puyr
䙰	puyr
䘨	puyw
袨	puyx
褵	puyx
䘸	puyy
户	pv
遤	pv
啔	pvab
䁉	pvam
肈	pvav
䋯	pvax
启	pvb
啟	pvbt
違	pvbt
扈	pvbv
避	pvby
扇	pvcc
戹	pvcg
㦾	pvcl
㧀	pvcy
㦿	pvd
逯	pvh
肩	pvii
逮	pvio
遲	pvit
迳	pvj
遐	pvjv
㧁	pvjx
邆	pvku
䢖	pvl
扂	pvlb
扃	pvmb
翩	pvmc
㼐	pvme
扁	pvmf
通	pvmj
帍	pvml
㓲	pvmn
鶣	pvmq
㲢	pvmt
騗	pvmv
甂	pvmy
㧂	pvnb
扉	pvnf
扊	pvoo
䢜	pvpm
退	pvq
扅	pvqq
鳸	pvqx
鵳	pvqx
扄	pvrb
雇	pvrl
顧	pvrs
戾	pvsu
㪐	pvsv
顅	pvsw
戻	pvsy
迉	pvt
啓	pvtb
遹	pvtb
棨	pvtd
䁈	pvtm
晵	pvtn
䏿	pvtq
肇	pvtv
綮	pvtx
戽	pvuf
遅	pvuh
肁	pvvl
焈	pvvo
戺	pvvp
逫	pvvv
選	pvvw
䋜	pvvx
迡	pvx
䋀	pvx
迟	pvy
房	pvyc
遟	pvyf
扆	pvyq
穴	pw
䆠	pwa
䆰	pwab
窃	pwac
窚	pwac
䆭	pwaf
窒	pwaj
窢	pwak
穿	pwal
䆾	pwam
䢔	pwb
䆛	pwba
窜	pwbl
䆔	pwbl
䆬	pwbm
窝	pwbw
䆗	pwbx
穵	pwcg
穷	pwct
窿	pwct
穼	pwd
窳	pwee
窊	pwex
䇀	pwfh
窦	pwfs
窴	pwfw
䆢	pwgw
窷	pwhc
窫	pwhs
窏	pwig
窪	pwij
䆱	pwio
䆮	pwiv
窙	pwjc
窐	pwjj
空	pwjl
竇	pwjm
㲁	pwjm
竈	pwjp
窥	pwjq
窺	pwjq
窾	pwjq
鵼	pwjq
穽	pwjr
窍	pwjx
窛	pwjx
竃	pwjx
穻	pwkg
䆑	pwkl
䆙	pwkl
竀	pwkq
窉	pwkw
窀	pwkx
窧	pwlf
䆽	pwls
窅	pwm
窩	pwmb
䆚	pwmb
帘	pwml
窋	pwmm
䆩	pwms
窠	pwnd
䆘	pwnp
䆨	pwns
窤	pwnx
䆞	pwnx
䆦	pwoo
窕	pwoq
䆼	pwpb
䆳	pwps
䢬	pwpt
窌	pwqc
逾	pwqn
䆫	pwqp
窞	pwqr
究	pwqt
䇁	pwqu
窇	pwqv
窎	pwqx
窵	pwqx
鴪	pwqx
䆴	pwqx
穸	pwqy
䆒	pwqy
竆	pwrb
窱	pwrd
䆤	pwrh
䆶	pwro
窻	pwrp
邈	pwrq
窗	pwrt
竅	pwrt
窮	pwrv
竄	pwrx
䆥	pwse
竂	pwsi
䆣	pwsj
鶟	pwsq
䆜	pwsq
竉	pwst
突	pwsu
䆖	pwsx
途	pwt
窖	pwtj
窄	pwtl
窂	pwtl
遥	pwtm
窑	pwtm
䆝	pwtm
窆	pwtp
穾	pwts
竁	pwtt
䆧	pwtx
窲	pwuf
䆵	pwun
窯	pwuo
窭	pwux
窶	pwux
窘	pwvb
䆷	pwvb
窟	pwvm
䆻	pwvt
䆸	pwvu
窡	pwvv
䆕	pwvw
穹	pwvx
䆯	pwvx
容	pwwb
逧	pwwb
䆟	pwwb
㮤	pwwd
彮	pwwe
窬	pwwn
䆺	pwwn
窸	pwwp
窰	pwwt
竊	pwwx
㼸	pwwy
窹	pwxb
窈	pwxc
梥	pwxd
窼	pwxd
䆿	pwxd
窓	pwxp
窽	pwxq
䆓	pwxq
㝐	pwxy
䢢	pwyb
窣	pwyf
䆲	pwyi
䆹	pwyj
窨	pwyn
䆡	pwyv
窔	pwyw
迨	pxb
邋	pxbx
鄳	pxc
巡	pxg
黽	pxii
遦	pxmw
逘	pxts
逡	pxwt
遪	pxxe
這	py
祴	pyaf
祬	pyaj
䄀	pyat
祵	pybd
祻	pybf
禪	pybf
䄄	pybg
䄇	pybh
邅	pybk
祌	pybl
祝	pybq
祦	pybs
祸	pybw
祁	pyc
䢍	pyc
祠	pycb
祒	pycb
祤	pycc
祂	pycl
礽	pycp
鿅	pydc
禫	pydf
禣	pydg
禋	pydj
䄥	pydw
祈	pyek
禠	pyem
祜	pyfb
禖	pyfd
遧	pyfg
祺	pyfh
禥	pyfj
禃	pyfm
䄍	pyfn
遮	pyfo
䄏	pyfs
䃽	pyfv
禛	pyfw
䄁	pyfx
这	pyg
迬	pyh
祷	pyhg
䄝	pyhr
禊	pyhs
礻	pyii
䄕	pyin
社	pyj
禧	pyjb
祮	pyjb
祎	pyjc
禱	pyjg
祙	pyji
䄣	pyjm
䀅	pyjm
禇	pyjn
䄊	pyjp
祾	pyjt
䃿	pyjw
祛	pyjx
䄤	pykm
福	pykn
䄚	pykn
祆	pyks
䄈	pyku
禰	pykw
䃼	pylg
祉	pyll
祯	pylm
禎	pylm
禂	pymb
禍	pymb
禤	pymc
適	pymf
迒	pymg
祖	pymh
视	pymq
視	pymq
禯	pyms
䄃	pyms
禮	pymu
祋	pymv
禢	pync
祼	pynd
禓	pyne
神	pynl
禔	pynl
䗝	pynl
䄂	pyno
禗	pynp
禵	pyns
禝	pynt
禩	pynw
禑	pyny
䢦	pyof
祧	pyoq
禈	pypa
遆	pypm
禭	pyps
祕	pypt
䄙	pypw
祇	pyqa
祪	pyqc
祢	pyqi
䄞	pyqj
䄑	pyqn
祹	pyqt
祗	pyqy
礿	pyqy
䄡	pyqy
䄗	pyr
禆	pyrf
祔	pyrg
䄓	pyrh
祏	pys
祐	pysb
䄎	pysb
遃	pyse
祳	pysj
鿆	pysv
䄋	pysx
祓	pysy
禲	pysy
䄉	pyta
遊	pytc
祩	pyti
祍	pytj
祰	pytj
祚	pytl
禶	pytm
䄆	pytm
祣	pytq
祅	pyts
祑	pytw
䢟	pytw
䄔	pyty
禉	pyud
禅	pyuf
祥	pyuh
禚	pyuo
祱	pyuq
禙	pyuq
禷	pyus
祶	pyut
禌	pyux
䄛	pyux
祃	pyv
禡	pyv
禄	pyvh
祀	pyvp
禕	pyvt
祲	pyvv
䄌	pyvv
祫	pywb
禴	pywf
禬	pywn
䄖	pywn
䄒	pywp
迹	pywr
祄	pywr
禐	pywv
䢒	pyww
礼	pyx
祿	pyxi
逳	pyxq
禒	pyxs
禨	pyxw
䃾	pyxx
禞	pyyb
禟	pyyb
祊	pyyc
祽	pyyf
䄠	pyyk
禘	pyym
禳	pyyq
䄢	pyyr
䄜	pyyx
䄘	pyyy
月	q
䏼	qaat
膒	qabb
氒	qafg
氏	qag
胨	qaiw
胵	qaj
腻	qajm
膩	qajm
帋	qaml
昏	qan
䫒	qans
脦	qapu
䏘	qaqg
䐶	qaqn
䲭	qaqx
臔	qavm
氐	qay
邸	qayc
鸱	qayq
鴟	qayq
㪆	qayv
㲳	qayw
句	qb
膕	qbak
臊	qbbd
䐷	qbbf
腭	qbbx
㬽	qbbx
邭	qbc
劬	qbct
㬷	qbd
斪	qbek
胭	qbg
脭	qbh
䐕	qbhd
腘	qbhy
脵	qbks
肿	qbl
膭	qblm
䐣	qbm
脶	qbmw
䵶	qbpx
够	qbqq
欨	qbqw
鸲	qbqx
鴝	qbqx
雊	qbrl
䪷	qbsw
㲒	qbta
䐃	qbtd
敂	qbtw
胑	qbw
膃	qbwm
卬	qc
䏤	qcb
脇	qccc
肠	qce
肊	qcg
斵	qcke
肔	qcl
鄮	qcmc
贸	qcmw
貿	qcmw
留	qcnb
鶹	qcnq
鹠	qcnq
䏮	qco
䐲	qcrn
肋	qct
脡	qctj
脠	qctl
腱	qcvl
鵩	qcvq
服	qcvy
膠	qcwe
劉	qcwn
肕	qcy
䏜	qcy
臎	qcyf
䏰	qcyp
膊	qdgy
膞	qdgy
膘	qdji
䐺	qdnf
臛	qdrl
臑	qdsm
脯	qdu
匍	qdu
膤	qdvh
膝	qdwi
腰	qdxk
勿	qe
肜	qe
䑇	qeem
腯	qefm
胻	qeg
肵	qek
䀜	qem
甮	qemj
曶	qen
㫚	qen
刎	qeng
忽	qepu
脈	qeq
䝆	qese
㬟	qeun
䐫	qewl
胍	qex
匆	qey
怱	qeyp
臓	qfaa
臟	qfaa
𦙶	qfb
䑏	qfbr
腜	qfd
䐙	qff
膹	qffm
肝	qfl
䐈	qfmh
䐟	qfmj
䑅	qfmq
朠	qfms
䐜	qfmw
䐽	qfmy
腊	qfn
膜	qfns
臈	qfnw
䐵	qfnw
脖	qfpc
朦	qfps
䑃	qfps
䐭	qfqm
臒	qfrv
㬸	qfrx
腩	qfu
臙	qfuo
肢	qfvy
㬴	qfw
匒	qfwb
朑	qfx
䐑	qfxd
膵	qfyf
䐻	qfyf
㬻	qfyr
䐠	qfyr
儿	qg
䏳	qgek
脙	qgoy
胤	qgxq
肘	qgy
胀	qha
脹	qha
䐼	qhcx
䏪	qhd
䏾	qhjl
腠	qhks
肨	qhl
䐏	qhn
腈	qhq
脿	qhq
膆	qhx
尔	qi
玺	qihy
勹	qiii
膛	qij
覙	qimq
䐝	qimw
䏴	qiq
胱	qisx
䏚	qit
乐	qiw
脳	qiwx
肚	qj
膨	qjbe
䐍	qjbu
臌	qjbv
勻	qjg
䏡	qji
胿	qjj
膮	qjjs
肛	qjl
䐗	qjn
䏯	qjpu
朊	qjqg
䏓	qjqg
肼	qjr
䏝	qjv
肤	qjwg
肟	qjx
脚	qjxc
䐦	qjxm
㔩	qjxm
胠	qjxy
鱼	qk
鳡	qkap
胢	qkb
鲴	qkbf
脨	qkbi
匐	qkbn
腷	qkbn
膈	qkbu
脰	qkbu
鳄	qkbx
印	qkc
鲺	qkcl
鱽	qkco
鳛	qkcr
䏞	qkd
鳔	qkdj
鳕	qkdv
鲘	qkeb
鿸	qkex
鳓	qkfc
鲽	qkfd
鲯	qkfh
鲼	qkfm
鳠	qkfv
䏏	qkg
䲠	qkhn
鲭	qkhq
鲰	qkhv
䲤	qkid
鲿	qkix
鲒	qkjb
𬶮	qkjb
鲑	qkjj
鳍	qkjn
鿵	qkjp
鲮	qkjt
鲓	qkjx
鲄	qkkb
𬶠	qkki
鲾	qkkn
𬶟	qkkn
鲆	qkku
鲠	qkkw
鲀	qkkx
鲡	qkky
鲇	qklb
鲈	qklv
鲷	qkmb
鲖	qkmb
鳏	qkmi
肺	qkml
鲗	qkmn
䐬	qkmn
鳢	qkmu
脼	qkmy
鿕	qkmy
鲁	qkn
鳎	qknc
鲱	qknf
鲥	qkng
腖	qkni
鲤	qknj
鲣	qknj
鳀	qknl
鳁	qknm
𫚕	qknm
鲳	qknn
鲉	qkno
鳃	qknp
鳂	qknq
鳗	qknv
鲲	qknx
𬶐	qkoq
鲢	qkpa
鳊	qkpf
鿹	qkpm
鲩	qkpq
𬶍	qkpx
𩽾	qkpx
𬶋	qkqb
䲟	qkqc
𬶏	qkqc
𬶭	qkqj
𩾃	qkqq
鲍	qkqv
鲋	qkrg
鳇	qkrh
鳈	qkri
鲌	qkrn
鲵	qkrq
鲕	qksm
鲔	qksq
鳜	qksq
鱿	qksx
鲅	qksy
稣	qktd
鲦	qktd
鲊	qktl
鳅	qkto
鳆	qktt
鿴	qktu
鳤	qktv
鲧	qktx
鳝	qkub
䲡	qkud
鳟	qkug
鳉	qkug
鲜	qkuh
匉	qkuk
胓	qkuk
鳞	qkut
鳒	qkuw
鲪	qkvb
䏸	qkvb
鲫	qkvc
鲟	qkvg
鳚	qkvg
鱾	qkvk
鳋	qkvl
脻	qkvl
鲬	qkvm
鲃	qkvn
鲏	qkvv
胰	qkvw
䲝	qkwc
鲶	qkwp
鳐	qkwt
鲙	qkwx
鲐	qkxb
鲹	qkxe
脛	qkxj
鲻	qkxn
肫	qkxx
𫚭	qkxx
鲂	qkyc
鲸	qkyi
𩾌	qkyi
鳣	qkyk
鳙	qkyl
鿷	qkyn
鲚	qkyr
䲞	qkyu
鿶	qkyv
鲛	qkyw
鳑	qkyy
胋	qlb
㔪	qlbo
胩	qlkl
臚	qlnm
臄	qlse
胪	qlvt
角	qm
䀏	qm
觶	qmbf
䚧	qmce
㙰	qmcj
蟹	qmcl
解	qmct
觔	qmct
觙	qmcy
䚞	qmdw
䚦	qmem
觚	qmex
䚢	qmfd
觾	qmfo
䚭	qmfr
膿	qmfs
腆	qmfw
觵	qmfw
肌	qmg
觩	qmgy
䏣	qmh
觥	qmis
觘	qmit
䏥	qmj
觨	qmji
觟	qmjj
觰	qmjn
䐾	qmju
胴	qmkb
觫	qmki
䚙	qmkk
䐩	qmku
触	qml
朏	qmm
胐	qmm
觿	qmmb
觽	qmmc
觸	qmml
䚪	qmmq
臞	qmmr
䑍	qmmx
䚟	qmng
㓩	qmng
觛	qmnk
䚣	qmnl
䚡	qmnp
䚠	qmnx
䚤	qmny
觗	qmqa
觤	qmqc
䏹	qmqg
臅	qmql
觼	qmqt
鵤	qmqx
觝	qmqy
觹	qmrc
䚜	qmrf
膗	qmrl
觬	qmrq
觭	qmsb
腨	qmsm
胦	qmsy
觡	qmtb
䚩	qmtb
觞	qmte
觴	qmte
䚛	qmtj
䚚	qmtq
斛	qmuf
觯	qmuf
觧	qmuh
觲	qmut
䚬	qmut
股	qmv
腡	qmvb
觮	qmvh
䚨	qmvm
䚥	qmvu
觖	qmvw
肭	qmwg
䶺	qmwg
朒	qmww
䚗	qmwx
觻	qmxd
觓	qmxl
䏎	qmy
觪	qmyf
䚝	qmyf
旬	qn
甸	qnb
郇	qnc
㝁	qnck
腂	qnd
腓	qnf
䏷	qnfl
刖	qng
䤚	qnj
胆	qnk
腸	qnke
䐎	qnkl
腲	qnkq
腗	qnkr
胂	qnl
腽	qnmn
腢	qnmy
胛	qnp
腮	qnpu
㰬	qnqw
腥	qnth
銞	qnw
䐯	qnx
䐊	qnxx
乌	qo
䱌	qoa
䱠	qoaa
鰔	qoab
鰸	qoab
鯎	qoac
䱿	qoae
鰹	qoaj
䱛	qoak
鱤	qoap
䰹	qoat
鮔	qoav
鰄	qoax
鰋	qoax
鮰	qobb
鱢	qobd
鯝	qobf
鱓	qobf
鰮	qobm
䱒	qobv
鮂	qobw
鰐	qobx
邬	qoc
鄔	qoc
鮉	qocb
鮙	qocc
䱆	qocc
䰵	qock
鯅	qocl
鯴	qocl
鯭	qocm
魛	qoco
䲊	qocq
鰼	qocr
䱓	qoct
鰎	qocv
魥	qocy
鱏	qodf
鱄	qodg
鰾	qodj
鯂	qodk
鱩	qodn
鱬	qods
鯆	qodu
鱈	qodv
鯠	qodw
鮜	qoeb
䰺	qoek
魬	qoev
䲗	qoew
䱄	qoex
鿳	qoex
鮕	qofb
鰙	qofb
鰳	qofc
鰈	qofd
䲉	qofe
鯕	qofh
魽	qofj
鱝	qofm
䲛	qofm
䱜	qofn
鰗	qofq
鱹	qofr
鱯	qofv
鱑	qofw
䱋	qofw
鱴	qofy
䱑	qoge
鯄	qogy
鱷	qohb
䰷	qohl
鰿	qohm
鰆	qohn
鯖	qohq
䱪	qohq
䱮	qohs
鯫	qohv
鮿	qohx
鿐	qoid
烏	qoii
鱨	qoin
鮹	qoiq
魦	qoit
鯋	qoit
鮚	qojb
鱚	qojb
䲖	qojg
鮇	qoji
䱈	qoji
鮭	qojj
鯥	qojj
魟	qojl
鰪	qojm
鯺	qojn
鰭	qojn
䲋	qojn
魭	qojq
䲌	qojq
䲅	qojq
鱙	qojs
鯪	qojt
鯐	qojw
魼	qojx
鮱	qojx
鮳	qojx
魺	qokb
鯃	qokb
䱅	qokd
鯟	qoki
鰊	qoki
魱	qokk
䱎	qokk
䱍	qokk
䲔	qokk
䰳	qokl
魳	qokm
䲚	qokm
䰽	qokm
鯻	qokn
鰏	qokn
鰽	qokn
䱨	qokn
鮃	qoku
䱏	qoku
䱖	qokv
鮧	qokw
鯁	qokw
魨	qokx
鱺	qoky
鮎	qolb
䲐	qolc
鮛	qoli
鯱	qolm
鱸	qolm
鱋	qoln
鱥	qolt
䱙	qolv
鰬	qoly
鮦	qomb
鯛	qomb
䱉	qomh
鰥	qomi
鱰	qomj
鰂	qomn
䱻	qomp
鱞	qomq
鱡	qoms
䱀	qoms
鱧	qomu
䱺	qomu
魶	qomw
䱩	qomy
魯	qon
鰨	qonc
鯣	qone
鰑	qone
鯡	qonf
魝	qong
鰣	qong
鯉	qonj
鱪	qonj
䱇	qonk
鯷	qonl
鰛	qonm
鯧	qonn
鮋	qono
魻	qonp
鰓	qonp
鰃	qonq
鯹	qont
鰻	qonv
鿩	qonw
鯤	qonx
鰅	qony
朥	qooc
䲏	qooc
䱭	qook
䱴	qook
鮡	qooq
腅	qoow
鯶	qopa
鰘	qopa
鰱	qopa
鰫	qopb
鯿	qopf
䲇	qopi
鯮	qopj
鰚	qopk
鰰	qopl
魫	qopq
鯇	qopq
鱁	qops
鮅	qopt
魲	qopv
鮀	qopx
鮟	qopx
鱦	qopx
鮈	qoqb
鮠	qoqc
鮣	qoqc
魩	qoqe
朓	qoqg
脁	qoqg
鰶	qoqj
䱢	qoql
鰡	qoqn
鱻	qoqo
鰞	qoqo
䲜	qoqo
䲆	qoqo
鮸	qoqq
䱤	qoqr
鱌	qoqs
䲒	qoqt
䱡	qoqu
鮑	qoqv
歍	qoqw
鷠	qoqx
魡	qoqy
鮘	qora
鮴	qord
鰷	qord
䱝	qorf
鮒	qorg
鯓	qorh
鰉	qorh
鰁	qori
䱦	qorl
鮊	qorn
鯢	qorq
鮲	qors
鯸	qort
䱔	qort
魸	qorv
䱸	qorv
鯾	qorw
鱮	qorw
魤	qorx
鮖	qos
䱁	qosf
䱞	qosj
䱳	qosj
魾	qosk
鮞	qosm
鮪	qosq
鰖	qosq
鱖	qosq
魷	qosx
鮬	qosx
鮁	qosy
鱱	qosy
魠	qota
魹	qota
鮥	qotb
鯦	qotb
鱎	qotb
鱵	qotb
鯚	qotc
䲙	qotc
䰴	qotc
䰿	qotc
穌	qotd
鮏	qoth
鮢	qoti
鯌	qotj
䱰	qotj
鮓	qotl
鰤	qotm
鯏	qotn
鯯	qotn
鰍	qoto
鰒	qott
䲄	qott
鮗	qotu
䲘	qotv
䱃	qotw
䰻	qotw
鯀	qotx
鯘	qotx
䱕	qotx
魞	qoty
䲑	qoua
鱔	qoub
䱧	qouc
鰌	qoud
䱊	qoud
鮩	qouf
鱒	qoug
鮮	qouh
䱹	qouj
鱛	qoun
䲕	qoun
鮵	qouq
鮷	qout
鱗	qout
鱃	qouv
鰜	qouw
鰦	qoux
䱾	qoux
鱶	qouy
鰢	qov
鮶	qovb
鱊	qovb
魣	qovc
鯽	qovc
鰇	qovd
䱟	qovf
鱘	qovg
䲁	qovg
䱚	qovh
魢	qovk
鰠	qovl
鯒	qovm
鯞	qovm
鱍	qovm
䰾	qovn
䱬	qovq
䱼	qovq
鮄	qovr
鱐	qovr
䲎	qovt
鰯	qovu
鮍	qovv
鮼	qovv
鰕	qovv
灳	qow
魚	qow
鮯	qowb
䱽	qowb
魵	qowc
䱐	qowc
䱵	qowc
鯩	qowf
魜	qowg
鯑	qowm
鱕	qown
鱠	qown
魿	qowp
鯰	qowp
膌	qowq
魪	qowr
鮽	qowt
鯼	qowt
鰩	qowt
鱫	qowt
鰀	qowv
䰼	qowv
䲓	qoww
鮾	qowx
䰸	qowx
䰲	qox
鮐	qoxb
鱜	qoxc
䱂	qoxc
鱳	qoxd
䲃	qoxd
鯵	qoxe
鰺	qoxe
鱂	qoxg
鮨	qoxn
鯔	qoxn
䱲	qoxs
鮻	qoxt
魮	qoxx
鱲	qoxx
䰶	qoya
鰝	qoyb
魴	qoyc
鯙	qoyc
䱶	qoyc
䲈	qoyd
鱆	qoyf
䱣	qoyf
魰	qoyg
鯨	qoyi
鱇	qoyi
鱣	qoyk
鱅	qoyl
魧	qoym
䱱	qoym
鯍	qoyr
鱭	qoyr
鯲	qoyu
䲂	qoyv
鮫	qoyw
鮌	qoyx
鯜	qoyx
鯳	qoyy
鰟	qoyy
腪	qpaf
膣	qpaj
腟	qpaj
䑊	qpbm
膑	qpew
臗	qpfy
腚	qpg
腙	qpji
腔	qpjl
脘	qpjq
臏	qpkm
膼	qpmb
䐔	qpmf
脓	qpq
腕	qpqc
䏙	qpqg
䶻	qpqg
膸	qpsq
䏟	qpt
膖	qpth
膇	qptv
腿	qpvq
胺	qpxk
朋	qq
胝	qqay
朐	qqb
胊	qqb
脕	qqbq
肳	qqe
脗	qqeb
䐇	qqen
䐳	qqo
朤	qqqq
鹏	qqqx
鵬	qqqx
䏧	qqqy
䐄	qqrj
脆	qqsc
膽	qqsy
勼	qqt
肍	qqt
䏛	qqu
胞	qqv
㽰	qqvl
㬹	qqvl
脃	qqvn
肷	qqw
胸	qqwx
䐢	qqxx
匇	qqy
肑	qqy
肒	qqy
褜	qqyq
匔	qrbb
䐪	qrcp
䏫	qrd
脾	qrfg
胕	qrgy
腶	qrhm
腺	qrio
䑂	qrkw
脽	qrl
臇	qrlc
䐰	qrlq
胉	qrn
䑄	qrnr
膲	qrow
腉	qrqg
䐿	qrus
䏒	qrv
兜	qrvq
匑	qrvx
膄	qrvy
腴	qrwg
膍	qrwx
脴	qsb
腼	qsbj
豚	qse
䏵	qse
䐁	qse
䐛	qshd
脤	qsj
胯	qsjx
胚	qsk
䐀	qskb
肧	qsl
胹	qsm
脜	qsm
腌	qsnx
匎	qsnx
脄	qsow
䐒	qsqq
腝	qssy
胧	qst
朧	qst
肰	qsu
膫	qsui
胈	qsvy
䐓	qsw
脥	qsww
肬	qsx
肱	qsxy
肽	qsy
九	qt
胳	qtb
叴	qtb
卯	qtc
䏗	qtc
乮	qtcc
肐	qtcg
㐇	qtcg
胣	qtcl
杂	qtd
雑	qtdr
卆	qtfg
腄	qtfk
膴	qtfo
㐤	qtfw
胜	qth
䏺	qthl
䏭	qtiw
䏕	qtj
㬶	qtj
㭀	qtjw
㬳	qtk
腁	qtkf
腫	qtkj
臐	qtko
胙	qtlg
虓	qtlm
匋	qtm
䏦	qtm
旭	qtn
旮	qtn
膓	qtne
脷	qtng
腹	qtnt
䐐	qtow
臜	qtqm
臢	qtqm
鸠	qtqx
鳩	qtqx
䲥	qtqx
䧱	qtrl
㐡	qtss
頄	qtsw
胮	qttj
脌	qttj
膬	qttt
馗	qtur
䏨	qtv
卿	qtvc
胅	qtwg
腇	qtxk
胏	qtxt
脢	qtxu
厹	qtxy
丸	qty
訄	qty
䎠	qtys
奿	qtyx
匀	qu
腃	quc
孵	qucc
毈	qucm
贕	qucm
㤻	qucp
勝	quct
卵	qucy
脒	qud
匊	qud
榺	qud
胼	quf
羘	quh
膶	quh
滕	quio
胖	quj
塍	quj
䐤	qujl
䑌	quki
螣	qul
膡	qum
幐	quml
㬺	quml
黱	qumo
賸	qumw
脱	quq
㔨	quq
䲢	quqk
鰧	quqo
膦	quqt
鵴	quqx
朕	qusy
膳	quub
腾	quv
騰	quv
䏲	quvt
膁	quw
膉	quwm
縢	qux
媵	quxk
膢	quxk
𦝼	quxk
謄	quy
䑆	quyv
包	qv
腛	qvaj
勉	qvbc
勨	qvbc
酁	qvbc
膙	qvbl
劖	qvbn
免	qvbq
鵵	qvbq
䴂	qvbq
象	qvbs
㚟	qvbs
㲋	qvbx
兔	qvby
毚	qvby
䑀	qvby
䐚	qvc
䏱	qvcb
䏔	qvf
腒	qvfb
䐂	qvh
脲	qvio
胫	qvj
䐸	qvjk
腵	qvjv
膯	qvku
亇	qvl
蜰	qvl
䏖	qvl
䐹	qvlr
烉	qvmo
奂	qvms
奐	qvms
夐	qvmt
敻	qvmt
匓	qvmv
负	qvmw
負	qvmw
肥	qvn
刨	qvng
龟	qvnx
亀	qvnx
炰	qvow
胇	qvr
臽	qvrj
燄	qvro
㷺	qvro
欿	qvrq
鵮	qvrq
鹐	qvrq
厃	qvs
危	qvsc
䣀	qvsc
頠	qvss
𬱟	qvss
矦	qvst
㩻	qvsv
詹	qvsy
甔	qvsy
腬	qvtd
䐅	qvts
䐖	qvud
䐞	qvuu
䏢	qvv
邹	qvvc
刍	qvvh
争	qvvl
色	qvvn
煞	qvvo
急	qvvp
雏	qvvr
皱	qvvv
腏	qvvv
䏐	qvwg
胒	qvx
久	qvy
々	qvy
灸	qvyo
粂	qvyu
麁	qvyx
欠	qw
匌	qwb
䏩	qwb
脫	qwbq
臉	qwbw
脬	qwck
朌	qwco
肦	qwco
胁	qwct
脎	qwd
䐆	qwd
胗	qwe
肸	qwfg
勽	qwg
脟	qwgy
脸	qwik
脍	qwjx
䐘	qwkv
肹	qwkx
腀	qwmf
膾	qwmn
膰	qwn
朎	qwp
腧	qwqn
脪	qwsm
腳	qwwc
脞	qwwj
䑎	qwwk
䐥	qwxc
脮	qwxk
匈	qwxl
䐋	qwxp
䶼	qwxp
胷	qwxq
膎	qwxs
朡	qwxt
䶽	qwxt
匁	qwy
腍	qwyp
肣	qwyv
鸟	qx
匂	qx
䳼	qxab
胎	qxb
䳅	qxbw
臘	qxbx
鄥	qxc
鳦	qxcg
鳨	qxct
枭	qxd
梟	qxd
䲷	qxd
鄡	qxdc
鷈	qxem
鶀	qxfh
䴌	qxfs
鹱	qxfv
鸌	qxfv
䳖	qxhx
鳥	qxii
肗	qxk
鴚	qxkb
凫	qxmg
鳧	qxmg
鳬	qxmg
䴋	qxmq
岛	qxmx
島	qxmx
㠀	qxmx
脂	qxn
䐉	qxnb
鵿	qxnf
鸔	qxni
䳹	qxpv
鴥	qxpw
鸵	qxpx
鴕	qxpx
䲬	qxqa
鄒	qxqc
䳃	qxqc
鶵	qxqq
㱀	qxqq
雛	qxqr
皺	qxqv
䳈	qxqv
芻	qxqx
鴏	qxra
鵻	qxrl
鶃	qxrq
䳧	qxrt
腦	qxrw
腞	qxse
䳁	qxsy
䲦	qxsy
䳗	qxta
䳘	qxta
鴼	qxtb
䏬	qxtl
鶳	qxtm
鴤	qxtu
䳀	qxtw
胟	qxu
鸃	qxua
鷌	qxv
鵦	qxvh
鴃	qxvw
匃	qxwg
䳶	qxws
朘	qxwt
脧	qxwt
鵌	qxwt
肶	qxx
䑈	qxxd
䏶	qxxj
鵔	qxxt
勾	qxy
膷	qxyc
䲱	qxyc
袅	qxyq
裊	qxyq
䙚	qxyq
鷻	qxyt
夕	qy
訇	qy
匄	qya
膱	qyat
名	qyb
䏽	qyb
䐧	qybb
朜	qybc
脝	qybc
膻	qybk
䑋	qybq
㬿	qybt
㗮	qybw
䑉	qyby
肪	qyc
夗	qyc
夘	qyc
邜	qyc
䖤	qycl
眢	qycm
盌	qycm
㠾	qycm
㽜	qycn
怨	qycp
鸳	qycq
鴛	qycq
臍	qycr
駌	qycv
妴	qycx
㼝	qycy
㚈	qyfg
頯	qyfs
勺	qyii
脉	qyio
䳮	qyiq
脏	qyj
祭	qyji
豋	qyku
外	qylg
䀤	qylm
夞	qylx
䐱	qymf
肮	qymg
䏑	qymw
腤	qyn
朣	qynj
膧	qynj
膟	qyof
爒	qyoi
炙	qyow
臕	qyow
㸋	qyow
膪	qypb
腣	qypm
臆	qypu
夤	qypw
膀	qypy
夡	qyqb
㚋	qyqb
卶	qyqc
翗	qyqc
㚌	qyqd
㚍	qyqm
㷇	qyqo
夠	qyqq
䫂	qyqs
郺	qyqv
㩼	qyqv
㚊	qyqw
多	qyqy
脐	qyr
腑	qyrg
腋	qyry
然	qyso
䳿	qysq
䐮	qyst
桀	qytd
夝	qyth
舛	qytj
㘶	qytj
䏠	qyu
斘	qyuf
臁	qyuw
朖	qyv
膅	qyvb
脺	qywf
飧	qywv
胶	qyww
㬵	qyww
脑	qywx
肞	qywy
膔	qyx
臃	qyxr
胲	qyxw
胘	qyxx
詧	qyy
䚻	qyy
䌛	qyyx
的	r
俴	raat
傴	rabb
柋	rad
伡	raf
俥	raf
㑘	raf
㑌	rah
㒑	rair
㑈	raiw
侄	raj
垡	raj
垈	raj
侙	rajl
㒃	rajm
伢	ral
傶	rali
帒	raml
黛	ramo
贷	ramw
貸	ramw
岱	ramx
倒	rang
偃	ranx
僭	raqn
侥	rasx
伐	rat
牮	ratl
儖	ratm
僌	ratw
佢	rav
㒘	ravy
伛	rawy
代	ray
袋	rayq
鬼	rb
㐰	rb
魊	rbak
魆	rbax
侣	rbb
佪	rbb
偘	rbbb
僺	rbbd
僤	rbbf
儼	rbbt
偔	rbbx
保	rbd
堡	rbdj
魒	rbdj
賲	rbdm
煲	rbdo
㷛	rbdo
䳰	rbdq
鬽	rbe
䰢	rbeg
鬿	rbek
囪	rbey
個	rbfb
郫	rbfc
卑	rbfg
魌	rbfh
鹎	rbfq
鵯	rbfq
䫌	rbfs
鬾	rbfv
㪏	rbfv
㼰	rbfy
侱	rbh
偮	rbhd
魈	rbiq
魅	rbji
䰫	rbjs
㒁	rbju
俣	rbks
魉	rbkw
魎	rbky
仲	rbl
促	rbll
僓	rblm
䰧	rblm
魖	rbln
傊	rbm
䰣	rbmw
魍	rbmy
魓	rbnj
䰠	rbnl
㑆	rbqg
侃	rbr
侶	rbrb
䰦	rbrf
魋	rbrl
諐	rbry
䫥	rbsw
魃	rbsy
悤	rbtp
㑨	rbts
囱	rbtw
䰡	rbtw
䰮	rbua
魁	rbuf
魐	rbuw
粤	rbux
䰬	rbvb
䰨	rbvm
俋	rbvn
伿	rbw
㔡	rbwc
恖	rbwp
魀	rbwr
顖	rbws
䪿	rbws
粵	rbwx
囟	rbwy
俁	rbxs
䰯	rbxv
魕	rbxw
魑	rbyx
伺	rcb
伽	rcb
佋	rcb
亿	rcg
㺱	rchy
㑚	rcjc
仔	rck
他	rcl
仍	rcp
怹	rcpu
㒛	rcrl
仂	rct
侹	rctj
健	rcvl
僇	rcwe
仞	rcy
仭	rcy
伋	rcy
㒊	rcyl
休	rd
傈	rdd
㑣	rdd
僸	rddj
儊	rddv
価	rdg
傅	rdgy
傳	rdgy
僄	rdji
体	rdk
價	rdmw
烋	rdow
僡	rdpu
恷	rdpu
僲	rdqt
鸺	rdqx
鵂	rdqx
儒	rdsm
僊	rdsv
俌	rdu
僳	rdud
倈	rdww
倯	rdwx
偠	rdxk
儨	reem
偱	refm
俇	reh
偫	rejg
伒	rek
㑟	rekw
傂	relm
俽	reqw
侜	reu
仮	revy
傱	rewl
傤	rfaf
儎	rfaf
估	rfb
僅	rfbh
儺	rfbr
傼	rfbw
㒋	rfek
僷	rffd
偾	rffm
僨	rffm
什	rfg
倛	rfh
傇	rfhd
佄	rfj
㒗	rfja
㒂	rfjn
㑸	rfkb
仠	rfl
值	rfmh
傋	rfmj
儚	rfmq
偀	rfms
傎	rfmw
㒝	rfmy
借	rfn
㑤	rfnb
僙	rfnw
㒖	rfny
侼	rfpc
僃	rfqm
僀	rfqm
儆	rfqt
僛	rfqw
偌	rfsb
備	rftm
㷶	rfto
憊	rftp
做	rftw
㑲	rfu
伎	rfvy
供	rfw
䣏	rfwc
儰	rfwo
偡	rfx
伳	rfx
偞	rfxd
㖚	rgbx
㑜	rgek
䵾	rgjv
俅	rgoy
怤	rgpu
姇	rgxk
付	rgy
身	rh
仼	rh
伥	rha
倀	rha
軀	rhab
躯	rhaw
躽	rhax
躳	rhbb
軃	rhbf
䠿	rhbm
倻	rhc
躱	rhcd
躵	rhcp
偰	rhcs
佴	rhd
躰	rhdk
㑝	rhf
仨	rhg
射	rhgy
俦	rhgy
躼	rhha
㒤	rhhh
㒥	rhhu
㑍	rhi
躺	rhib
傣	rhio
軇	rhjg
俸	rhjl
仹	rhl
躲	rhmd
䠳	rhmm
儬	rhmq
軆	rhmu
䠽	rhmu
段	rhmv
债	rhmw
債	rhmw
偆	rhn
躶	rhnd
軂	rhoc
䠷	rhoq
躻	rhpj
軉	rhpm
躭	rhpq
䠻	rhpv
倩	rhq
俵	rhq
躹	rhqu
鵢	rhqx
䠵	rhrg
躸	rhsb
軅	rhsr
䡁	rhst
䠸	rhsx
䠶	rhts
傲	rhtw
躷	rhtx
䠺	rhub
躾	rhus
䠾	rhuw
軁	rhux
躬	rhvx
躮	rhwc
䠼	rhwn
䠲	rhwp
傃	rhx
㑙	rhx
軄	rhya
躿	rhyi
䡀	rhyk
軈	rhyp
䠴	rhyu
躴	rhyv
䠹	rhyw
川	ri
㒉	rid
亻	riii
㑽	rij
偿	rijx
倘	rimb
儻	rimo
僘	rimt
償	rimw
儅	rinb
㲻	rio
傥	rip
俏	riq
侊	risx
仯	rit
偗	ritm
仦	riw
仕	rj
舆	rjaw
輿	rjaw
佶	rjb
儓	rjba
僖	rjbb
伟	rjc
侾	rjck
舁	rjf
仁	rjg
侍	rjgy
臼	rjii
盥	rjim
佅	rjiw
佳	rjj
毁	rjjm
毀	rjjm
僥	rjjs
㩓	rjjt
䥣	rjjw
轝	rjka
㐦	rjkc
舉	rjkj
䑖	rjkl
䑔	rjkm
舃	rjko
㦛	rjkp
歟	rjkq
鸒	rjkq
礜	rjks
擧	rjkt
與	rjkw
侤	rjkx
譽	rjky
㼂	rjky
仜	rjl
釁	rjmc
䑕	rjmj
帠	rjml
儥	rjmm
舋	rjmm
爨	rjmo
爂	rjmo
㸑	rjmo
臖	rjmq
興	rjmw
璺	rjmy
偖	rjn
舅	rjnc
䑗	rjne
俧	rjpu
郳	rjqc
兒	rjqg
㐾	rjqg
舄	rjqo
鶂	rjqq
㪒	rjqv
䳎	rjqx
䳔	rjqx
䢉	rjrs
䢅	rjsj
夓	rjst
䊆	rjud
倖	rjuj
䑘	rjuj
毇	rjum
传	rjv
鄋	rjvc
儔	rjvg
㲣	rjvt
㪢	rjvv
叟	rjvy
學	rjwc
斞	rjwf
臾	rjwg
伕	rjwg
澩	rjwi
壆	rjwj
儧	rjwm
嶨	rjwm
䁷	rjwm
䝿	rjwm
僣	rjwn
燢	rjwo
鱟	rjwo
惥	rjwp
覺	rjwq
觷	rjwq
鷽	rjwq
䑁	rjwq
䶾	rjwq
雤	rjwr
礐	rjws
倰	rjwt
斆	rjwt
嚳	rjwt
斅	rjwv
䮸	rjwv
黌	rjww
㽇	rjwy
佬	rjx
鼲	rjxa
鼯	rjxb
鼦	rjxb
鿼	rjxb
鼢	rjxc
㑢	rjxc
鼠	rjxg
鼭	rjxg
䶈	rjxg
鼱	rjxh
佞	rjxk
鼰	rjxm
鼶	rjxm
鿻	rjxm
鼬	rjxn
鼺	rjxn
䶉	rjxn
鼩	rjxq
䶇	rjxq
䶂	rjxq
䶆	rjxr
鼷	rjxs
鼣	rjxs
鼫	rjxs
鼳	rjxs
鼵	rjxs
鼪	rjxt
鼮	rjxt
䶅	rjxt
鼨	rjxu
鼸	rjxu
䶄	rjxu
䶃	rjxv
鼹	rjxx
鼧	rjxx
鼴	rjxx
伝	rjxy
佉	rjxy
鼤	rjxy
鼥	rjxy
倵	rkal
何	rkb
㑛	rkbi
倳	rkbl
偪	rkbn
儾	rkbq
侸	rkbu
使	rkbw
侀	rkfn
㐵	rkg
仃	rkl
佂	rkll
傿	rklo
侢	rkmj
伂	rkml
傮	rkmn
俩	rkmw
㑂	rkmw
俪	rkmy
倆	rkmy
儷	rkmy
例	rkng
倲	rkni
僵	rknk
僫	rknp
俨	rknt
俹	rknu
便	rknw
㒎	rksn
俫	rkud
伻	rkuk
侠	rkus
伍	rkv
俉	rkvb
倢	rkvl
侇	rkvw
儞	rkww
仗	rkwy
俓	rkxj
仾	rkxk
伅	rkxx
佤	rkxy
售	rlb
佔	rlb
隽	rlcp
集	rld
隼	rlfg
鶽	rlfq
仆	rlg
隹	rlii
仩	rlk
㑐	rlki
佧	rlkl
俶	rlkv
雋	rllc
俿	rlmg
侦	rlmw
偵	rlmw
倬	rlnf
儢	rlnp
劁	rlon
鹪	rloq
鷦	rloq
顦	rlos
㲬	rlot
焦	rlow
㒠	rlqk
燞	rlqo
儏	rlqu
䳡	rlqx
雧	rlrd
雔	rlrl
㸈	rlro
雥	rlrr
雦	rlrr
䨊	rlrr
犨	rlrt
雙	rlrv
䨇	rlrv
讐	rlry
顀	rlsw
翛	rltc
條	rltd
修	rlte
鞗	rltf
䩦	rltf
跾	rltl
䖺	rltl
儵	rltm
䀺	rltm
偹	rltn
㫦	rltn
倐	rlto
焂	rlto
鯈	rlto
悠	rltp
脩	rltq
倏	rlts
攸	rltw
鋚	rltw
鎥	rltw
絛	rltx
㛜	rltx
偼	rlvl
候	rlvt
隻	rlvy
佌	rlx
偨	rlxd
㘜	rlyb
雠	rlyr
讎	rlyr
犫	rlyt
䧶	rlyw
自	rm
向	rmb
䚁	rmbq
郋	rmc
臬	rmd
臲	rmdc
㓷	rmdn
鷍	rmdq
甈	rmdy
㑋	rmfk
儂	rmfs
僼	rmfu
倎	rmfw
仉	rmg
伹	rmh
佣	rmj
倜	rmjb
侗	rmkb
佩	rmkm
儇	rmkq
㑉	rmkq
倶	rmkw
臰	rmkx
㑁	rmm
伵	rmn
儩	rmne
鼾	rmnf
侧	rmng
側	rmng
齂	rmni
齄	rmnk
䶑	rmnl
齇	rmnm
劓	rmnn
䶐	rmnn
鼽	rmnq
齁	rmnq
齉	rmnq
䶌	rmnq
鼻	rmnr
鼿	rmns
齅	rmns
齈	rmns
齆	rmnv
䶊	rmnv
齃	rmnw
䶎	rmnw
鼼	rmnx
齀	rmny
䶋	rmny
翺	rmoc
臯	rmof
鷱	rmoq
傦	rmp
鄎	rmpc
䫵	rmps
息	rmpu
臱	rmpy
伣	rmqg
俔	rmqg
㒔	rmql
傰	rmqq
㑕	rmqy
㑩	rmqy
儶	rmrb
㒞	rmrc
催	rmrl
臮	rmrw
鄓	rmsc
偳	rmsm
臭	rmsu
䫁	rmsw
佒	rmsy
偑	rmtl
嶴	rmum
䴈	rmuq
奥	rmus
伇	rmv
俱	rmw
㐻	rmwg
奧	rmws
侺	rmwv
㐽	rmwy
仙	rmx
臫	rmx
儸	rmxr
辠	rmyf
㺸	rmyh
白	rn
皂	rnag
佃	rnb
傝	rncc
䎅	rncc
侽	rnct
劰	rnct
倮	rnd
皬	rndr
皈	rnev
俳	rnf
皁	rnfg
儤	rnfi
皣	rnfj
皇	rnh
皟	rnhm
㿤	rnhn
皘	rnhq
䳨	rnhq
皝	rnhs
皩	rnhs
㣎	rnie
㣐	rnie
灥	rnii
㿩	rnim
泉	rnio
㿠	rnis
俚	rnj
㿧	rnjg
皢	rnjs
但	rnk
皌	rnkd
偒	rnke
偍	rnkl
偎	rnkq
㑭	rnkr
俜	rnkx
㼟	rnky
伸	rnl
敒	rnlt
皉	rnlx
皗	rnmb
帛	rnml
皠	rnmr
皚	rnmu
皑	rnmv
僈	rnmv
緜	rnmx
偶	rnmy
倡	rnn
畠	rnnb
皔	rnnf
㒦	rnnj
儡	rnnn
㿣	rnnw
儽	rnnx
伷	rno
翶	rnoc
皐	rnof
㿡	rnoq
皖	rnpq
㿥	rnpr
偲	rnpu
㑥	rnqe
皃	rnqg
偈	rnqw
䳆	rnqx
的	rnqy
魄	rnrb
皥	rnrf
皞	rnrf
皡	rnrf
皨	rnrj
㿟	rnrn
皛	rnrr
皦	rnrt
翱	rnsc
䣗	rnsc
皋	rnsf
㿨	rnsl
㡍	rnsm
鷎	rnsq
䚌	rnsq
䫧	rnss
㚖	rnsy
皒	rnta
㿞	rnta
㑼	rntb
皓	rntj
敀	rntw
皏	rnuf
僕	rnuh
㒒	rnuh
㑠	rnvj
皅	rnvn
㒵	rnw
皭	rnwg
皤	rnwn
皊	rnwp
皧	rnwt
傫	rnx
癿	rnx
皀	rnx
卽	rnxc
皍	rnxc
皪	rnxd
墍	rnxj
曁	rnxk
儑	rnxo
旣	rnxq
倱	rnxx
㿝	rnxy
皜	rnyb
皫	rnyo
㦘	rnyp
鸄	rnyq
䚫	rnyq
㰾	rnyq
敫	rnyt
皎	rnyw
譥	rnyy
㑞	rof
僗	rooc
儝	rood
㒌	room
倓	roow
佻	roqg
伙	row
僆	rpaf
㑮	rpaf
儙	rpbv
傓	rpcc
俕	rpd
傧	rpew
僿	rpfj
㒏	rpfu
㑏	rpgy
倧	rpji
倥	rpjl
俒	rpjq
㒓	rpju
伫	rpk
佇	rpkl
儐	rpkm
偏	rpmf
伔	rpmg
儜	rppk
㑻	rppm
侬	rpq
倇	rpqc
傕	rprl
僱	rprl
傢	rpse
㑦	rpsu
佖	rpt
侘	rpta
伈	rpu
倌	rpv
僒	rpvb
傛	rpwb
佗	rpx
僶	rpx
侒	rpxk
仴	rq
低	rqay
佝	rqb
佲	rqb
俛	rqbq
像	rqbs
㖌	rqbx
儳	rqby
仰	rqc
伆	rqe
偬	rqep
伜	rqfg
你	rqi
傺	rqji
偩	rqmw
侚	rqn
您	rqpu
倗	rqq
侈	rqqy
佹	rqsc
㒄	rqso
儋	rqsy
仇	rqt
傑	rqtd
伨	rqu
佨	rqv
㑇	rqvh
鿇	rqvl
俷	rqvn
㐸	rqw
㑳	rqxx
仢	rqy
㑾	rqy
㐴	rqy
傀	rrb
㑖	rrbl
㑺	rrcp
俾	rrfg
偟	rrh
㑗	rrh
㒜	rrkw
倠	rrl
儁	rrlc
㑑	rrm
伯	rrn
僬	rrow
倪	rrqg
㒨	rrrv
傯	rrtp
傁	rrvy
㐺	rrwg
傻	rrwt
儌	rryt
佦	rs
佑	rsb
俖	rsb
㐛	rsbc
偭	rsbj
伌	rsc
倴	rsff
傉	rsgy
侲	rsj
倷	rsji
佐	rsjl
侉	rsjx
伾	rsk
倚	rskb
伓	rsl
侟	rslc
侕	rsm
佈	rsml
優	rsmt
佰	rsn
俺	rsnx
侑	rsq
偧	rsqq
傆	rsri
偄	rssy
儱	rst
儮	rstl
伏	rsu
僚	rsui
傄	rsum
伖	rsvy
顺	rsw
順	rsw
㑯	rsw
㑔	rsw
俠	rsww
傸	rsww
优	rsx
㐳	rsx
㐲	rsy
㑀	rsy
仛	rtag
俄	rtat
佫	rtb
俰	rtb
倁	rtb
偊	rtby
㐹	rtc
仡	rtcg
㑧	rtck
伤	rtct
栠	rtd
䣸	rtdk
俢	rte
㐼	rtf
仟	rtfg
倕	rtfk
㒇	rtfo
偛	rtfr
儛	rtft
㐿	rtg
侏	rtiw
任	rtj
俈	rtj
仵	rtk
働	rtkc
倂	rtkf
偅	rtkj
件	rtl
倃	rtlb
作	rtlg
㑅	rtlk
偺	rtln
㤰	rtlp
佸	rtm
凭	rtmg
侐	rtmn
赁	rtmw
賃	rtmw
俻	rtnb
傷	rtne
俐	rtng
僽	rtop
偢	rtow
㶵	rtow
恁	rtpu
侁	rtqg
儹	rtqm
㒐	rtqn
鵀	rtqx
僑	rtsb
侨	rtsr
仸	rtsy
佭	rttj
佟	rtu
㑶	rtud
佚	rtwg
係	rtx
䋕	rtx
倭	rtxk
侮	rtxu
仫	rtxy
俬	rtxy
偸	rtyx
倦	ruc
伪	rucy
侎	rud
僔	rudg
偤	rudk
併	ruf
佯	ruh
伴	ruj
傞	rujl
僧	rumn
僴	run
𫢸	runf
们	rup
們	rup
侻	ruq
偝	ruq
僩	ruq
偂	ruqn
僯	ruqt
佽	ruqw
儀	ruta
㑵	ruts
僐	ruub
儯	ruv
偽	ruvo
俤	ruvt
傔	ruw
偻	ruxk
僂	ruxk
片	rv
佀	rv
傌	rv
㐷	rv
牋	rvaa
偓	rvaj
偉	rvbt
僻	rvby
伃	rvc
㑡	rvc
侷	rvcb
牊	rvcb
僝	rvcc
牔	rvdg
版	rvev
倨	rvfb
牒	rvfd
㸢	rvfm
牍	rvfs
㒈	rvht
牘	rvjm
假	rvjv
僜	rvku
伄	rvl
侓	rvl
儘	rvlm
俑	rvmj
倔	rvmm
覑	rvmq
㸣	rvnu
㸠	rvoq
㐶	rvp
牖	rvpd
牑	rvpf
侵	rvpv
㑴	rvpv
佷	rvq
偦	rvq
牎	rvqp
㸝	rvqw
㸥	rvqy
佛	rvr
牌	rvrf
傩	rvrl
牕	rvrp
㸞	rvrv
伊	rvt
㲏	rvta
侰	rvtb
僪	rvtb
鄇	rvtc
㑱	rvtd
㸡	rvti
鿙	rvtq
牐	rvtr
侯	rvts
䫛	rvts
鿚	rvtt
鿘	rvtw
偋	rvuf
牉	rvuj
佊	rvv
僎	rvvw
牏	rvwn
伲	rvx
㸟	rvxn
仅	rvy
伬	rvy
牗	rvyl
侭	rvyu
牓	rvyy
仈	rw
佮	rwb
㒢	rwbf
倹	rwbw
儉	rwbw
伧	rwc
㒆	rwcc
俘	rwck
份	rwco
倸	rwd
佺	rwh
俭	rwik
伱	rwiw
㒚	rwjp
侩	rwjx
倫	rwmf
偁	rwmj
儈	rwmn
佡	rwmx
僠	rwn
儍	rwot
伶	rwp
僢	rwpt
僾	rwpt
僁	rwpu
佾	rwq
偷	rwqn
价	rwr
俙	rwsm
倄	rwsq
俆	rwt
倽	rwtm
傜	rwtm
僞	rwto
㒡	rwtx
俗	rwwb
侳	rwwj
伦	rwx
傟	rwxc
俀	rwxk
倊	rwxp
傒	rwxs
伀	rwxy
傖	rwyb
僋	rwym
㑫	rwyp
仱	rwyv
化	rx
佁	rxb
侞	rxb
儠	rxbx
㑬	rxfb
华	rxfg
値	rxfm
㚢	rxk
货	rxmw
貨	rxmw
㑎	rxmx
㑿	rxnd
㑷	rxqx
㒙	rxrm
㑰	rxse
㒩	rxsl
㑓	rxsv
倾	rxsw
傾	rxsw
侔	rxtl
俟	rxts
儗	rxtv
㑄	rxu
伮	rxvy
俊	rxwt
仳	rxx
㑃	rxxc
傪	rxxe
偕	rxxr
僟	rxxw
㒍	rxxx
仏	rxy
似	rxyw
信	ry
倍	ryb
傐	rybb
倞	rybi
停	rybk
儃	rybk
偯	rybq
儴	rybq
僦	rybs
儫	rybs
仿	ryc
儕	rycr
儭	rydq
傽	ryfg
儣	ryfw
伩	ryg
傠	rygy
住	ryh
储	ryjn
儲	ryjn
㒀	rymf
伉	rymg
偣	ryn
僮	rynj
儦	ryow
偙	rypm
億	rypu
傍	rypy
依	ryq
傹	ryqg
㥋	ryqp
㒅	ryqq
侪	ryr
㑪	ryr
俯	ryrg
㒣	ryrp
偐	ryse
侂	ryta
倣	rytw
位	ryu
俍	ryv
傏	ryvb
傭	ryvl
㒟	ryvq
俲	rywc
倅	rywf
㒧	rywr
㑊	rywr
傚	rywt
佼	ryww
仪	rywy
侫	ryxk
倿	ryxk
傗	ryxn
俼	ryxq
㒕	ryxr
侅	ryxw
伭	ryxx
傡	ryyu
在	s
碊	saat
䂸	sabk
砌	saco
厍	saf
砗	saf
厙	saf
硨	saf
厔	saj
碱	sakb
䃭	sakp
砑	sal
厊	sal
磩	sali
砸	saml
䃡	saqn
硗	sasx
䂝	sat
礛	satm
䃘	savj
礥	savm
右	sb
硘	sbb
靣	sbb
𥖨	sbbd
磾	sbbf
礹	sbbt
𥔲	sbbx
硱	sbd
厛	sbek
䂩	sbg
磒	sbm
䩇	sbnb
勔	sbnc
䩊	sbnc
䩋	sbnd
䩉	sbnd
䩍	sbni
面	sbnj
蠠	sbnl
䩆	sbnl
靧	sbnm
䩌	sbno
靤	sbnq
靦	sbnq
䩄	sbnq
䩅	sbnv
䩂	sbnv
䩎	sbnw
䩈	sbnx
䩃	sbnx
䩏	sbny
䧺	sbrl
碅	sbtd
厑	sbx
厄	sc
䂙	sc
砀	sce
乭	scg
矷	sck
磖	scrn
顾	scsw
頋	scsw
历	sct
劯	sct
硟	sctl
磟	scwe
砐	scy
䂞	sd
碄	sdd
歴	sddl
礵	sddm
暦	sddn
厯	sddu
礎	sddv
䃻	sdfq
硒	sdg
磗	sdgy
磚	sdgy
䃌	sdj
磦	sdji
砵	sdk
厢	sdm
礌	sdnb
磹	sdnf
碴	sdnk
礭	sdrl
礝	sdsm
㕊	sdu
䂾	sdww
硹	sdwx
䝐	secq
豧	sedu
䝈	seec
豵	seel
礩	seem
碷	sefm
豮	sefm
豶	sefm
䝔	sefr
䝕	sehh
䝒	sehi
豕	seii
豖	seii
䝅	sej
櫫	sejd
豬	sejn
豷	seju
斫	sek
䂡	sek
豜	sekf
豣	sekf
䝊	sekl
豘	sekx
蟸	sell
磃	selm
豠	semh
䃲	semm
䀃	semn
䝎	sems
豛	semv
䃑	semv
剢	seng
豱	senm
䝍	sepa
豟	sepc
䝋	sepj
豞	seqb
豩	sese
豲	sesi
豳	sesm
燹	seso
甤	seth
䝏	seux
磤	sevm
豝	sevn
豤	sevq
豭	sevv
䝌	sevv
磫	sewl
豨	sewm
豯	sews
䝓	sexx
䂨	sey
豴	seyf
䝑	seyj
豥	seyw
礷	sfam
㕆	sfb
厪	sfbh
礶	sfbr
礡	sfdg
厮	sfek
䃆	sfh
礴	sfig
礚	sfjm
矸	sfl
厈	sfl
䃊	sfmh
䃓	sfmj
碤	sfms
厧	sfmw
磌	sfmw
礣	sfmy
厝	sfn
碏	sfn
勵	sfnc
䃱	sfnk
磺	sfnw
礍	sfnw
厲	sfny
礞	sfps
礤	sfqj
䃟	sfqt
硴	sfrx
硔	sfw
砹	sfwy
碪	sfx
磡	sfxc
碟	sfxd
硭	sfya
䂻	sha
碶	shcs
硦	shf
㕔	shhp
䂜	shl
碛	shmw
磧	shmw
碃	shq
厫	shtw
磝	shtw
碡	shxu
砡	shy
石	si
磲	siad
厂	siii
丆	siii
厰	simt
䂿	sin
礑	sinb
泵	sio
砅	sio
硝	siq
硄	sisx
砂	sit
礃	sitg
辰	sj
圧	sj
唇	sjb
硈	sjb
礂	sjbb
㕑	sjbg
䣅	sjc
硣	sjck
䃝	sjct
㦺	sjga
鄏	sjgc
辱	sjgy
硅	sjj
厓	sjj
磽	sjjs
左	sjl
蜃	sjl
矼	sjl
㲀	sjmv
碽	sjmw
䂵	sjmw
㫳	sjn
脣	sjq
毻	sjqt
㰮	sjqw
䫃	sjsw
敐	sjtw
砖	sjv
砆	sjwg
䢈	sjwn
硳	sjwr
碐	sjwt
硓	sjx
䂶	sjxc
磕	sjxm
㕎	sjxm
砝	sjxy
压	sjy
碔	skal
砢	skb
㕏	skbf
厨	skbg
䃒	skbu
励	skcc
厉	skct
砞	skd
研	skf
㕃	skf
硎	skfn
揅	skft
䊙	skfu
厅	skl
矴	skl
𥕢	skmn
礓	sknk
䃁	sknu
硬	sknw
硏	sksf
砰	skuk
硖	skus
䃀	skvx
硜	skxj
砘	skxx
㕄	skxx
砙	skxy
不	sl
否	slb
砧	slb
磠	slbo
䫊	slbs
硵	slbw
存	slck
嫑	sldx
㔻	slfg
在	slj
丕	slk
邳	slkc
歪	slkl
䲹	slkq
䪹	slks
砋	sll
甭	slmj
盃	slmn
覔	slmq
碵	slmw
㫘	sln
䂽	slnf
㶨	slow
㶪	slow
𬒔	slq
鴀	slqx
奀	slsy
䬩	slwv
䂣	slx
孬	slxc
而	sm
冇	sm
戛	smat
耏	sme
䃩	smfs
碘	smfw
矶	smg
耐	smgy
砠	smh
砽	smj
㕓	smj
碉	smjb
礋	smju
硐	smkb
碋	smkb
磑	smku
布	sml
础	smm
厕	smng
厠	smng
䎡	smow
磆	smp
戞	smpa
鄾	smpc
㥑	smpp
㱊	smpq
憂	smpt
恧	smpu
砚	smqg
硯	smqg
磞	smqq
鸸	smqx
鴯	smqx
䃬	smrb
磪	smrl
硸	smsf
㓴	smsn
碳	smso
奡	smsr
䰭	smsr
䫱	smss
耎	smsy
㼲	smsy
碸	smtl
夏	smtw
碙	smum
䃃	smuy
砓	smv
碢	smvb
硙	smvk
磮	smwf
硶	smwv
砜	smwy
耍	smxk
矾	smy
砃	smy
百	sn
鿬	snb
厚	snck
䂺	snd
厞	snf
矵	sng
厘	snj
䣑	snjc
碭	snke
碍	snkg
㕌	snkg
碮	snkl
碨	snkq
㼣	snky
砷	snl
㓦	snng
礧	snnn
㕅	snp
檿	snqd
壓	snqj
靨	snqj
㱘	snql
黶	snqm
厴	snqn
懕	snqp
魘	snqr
厭	snqs
擪	snqt
碣	snqw
饜	snqw
嬮	snqx
皕	snsn
厬	sntb
䃏	snth
𬒗	sntq
㪶	snuf
礏	snuh
磥	snx
礘	snxo
䃂	snxx
盔	somn
磱	sooc
㓹	soon
礯	soox
䂪	soqg
䃯	sord
灰	sow
䃛	spaf
䃔	spbb
砨	spcg
碇	spg
磍	sphb
碂	spji
硿	spjl
䃮	spju
碹	spkk
礗	spkm
碥	spmf
碗	spqc
䃰	spqj
確	sprl
䃐	spsu
硡	spsx
鿎	spsy
碦	sptb
磓	sptv
礈	spus
磀	spux
砣	spx
有	sq
戫	sqak
碈	sqan
㦽	sqax
砥	sqay
厎	sqay
郁	sqc
磂	sqcn
砕	sqfg
䂧	sqi
砾	sqiw
磜	sqji
确	sqm
䀁	sqmn
䃖	sqo
䂹	sqow
㤫	sqpu
硼	sqq
䳑	sqqx
硊	sqsc
龓	sqst
䃫	sqsy
磔	sqtd
㬼	sqtt
砲	sqv
碀	sqvl
砍	sqw
鳫	sqx
䲽	sqx
矽	sqy
磈	srb
磼	srd
碑	srfg
䂤	srgy
碫	srhm
厵	srii
厡	srio
愿	srip
願	sris
原	sriw
礖	srkw
碓	srl
㕍	srl
䃇	srml
砶	srn
礁	srow
贗	srqm
磶	srqo
㕐	srqo
鴈	srqx
雁	srrl
赝	srrm
贋	srrm
㷳	srro
礇	srus
磇	srwx
硇	srwy
礉	sryt
砳	ss
砈	ssc
厖	sse
硥	sse
硺	sse
礪	ssfy
㻹	sshy
碕	sskb
砺	sskc
黡	ssmo
厦	ssmt
厣	ssnp
硽	ssnx
磭	ssq
䃎	ssqq
魇	ssrb
磊	sss
靥	sssj
㔏	sssn
碝	sssy
厐	sst
礲	sst
龎	sst
礰	sstl
厌	ssu
硕	ssw
碩	ssw
餍	sswv
硤	ssww
磢	ssww
矹	ssx
龙	st
厇	stag
矺	stag
硪	stat
硌	stb
矻	stcg
砤	stcl
㰍	std
龏	stf
厜	stfk
硾	stfk
䂷	stfu
龚	stfw
龔	stfw
䶭	sth
聋	sthd
聾	sthd
龍	stii
硃	stiw
垄	stj
壟	stj
硞	stj
龒	stji
龑	stks
䶮	stks
蠪	stl
㸴	stl
砟	stlg
厏	stlg
厒	stm
䂰	stng
砭	stp
礸	stqm
鸗	stqx
砻	sts
礱	sts
䂠	sts
礄	stsb
硚	stsr
龘	stss
龖	stst
厤	sttd
䂫	sttj
歷	sttl
曆	sttn
㷴	stto
磿	stts
㻺	stty
㽁	stty
䂢	stu
驡	stv
詟	sty
讋	sty
袭	styq
襲	styq
犬	su
磸	suds
硑	suf
磋	sujl
䃹	suki
磳	sumn
磵	sun
䃅	sunf
碰	sunu
礀	suq
䂱	suq
磷	suqt
䃍	suse
飆	susl
猋	suss
㹜	susu
飙	susw
礒	suta
㕒	suta
磰	suub
磏	suw
橜	suxd
蟨	suxl
蹷	suxl
劂	suxn
憠	suxp
礠	suxp
厥	suxq
鷢	suxq
磁	suxx
礢	suyv
码	sv
碼	sv
䂥	svag
䃉	svan
厩	svaq
唘	svb
䃨	svbl
礔	svby
䂛	svc
碾	svfq
碌	svh
碿	sviq
硁	svj
碬	svjv
磴	svku
硉	svl
䃤	svlr
䀾	svm
硧	svmj
䃗	svng
硍	svq
砩	svr
破	svv
磉	svvd
砄	svwg
礟	svww
友	svy
犮	svy
䂘	svy
盋	svym
䳊	svyq
礮	svyw
页	sw
碒	sw
㕋	sw
硆	swb
㕉	swb
厱	swbw
礆	swbw
砏	swco
䂦	swe
仄	swg
硂	swh
頁	swii
硷	swik
砼	swjl
碖	swmf
磻	swn
砱	swp
䃋	swqn
䃢	swqw
砎	swr
顨	swsr
硢	swt
磘	swtm
䃣	swto
䫰	swut
硲	swwb
䪾	swwe
䂳	swwj
䃸	swwk
䂚	swwy
磎	swxs
䂼	swyp
砛	swyv
㕂	swyv
尤	sx
㔫	sx
䂗	sx
尶	sxam
尷	sxam
尵	sxbm
䃳	sxbx
翃	sxcc
尮	sxcd
尨	sxe
尪	sxh
尫	sxh
兀	sxii
尢	sxii
兀	sxii
㝽	sxio
㝼	sxkg
虺	sxl
䫺	sxml
尳	sxmp
㞅	sxnd
尴	sxnm
㞇	sxnq
㞁	sxnx
㞈	sxpf
卼	sxqc
尯	sxqc
䲫	sxqx
尥	sxqy
雄	sxrl
碯	sxrw
㞆	sxsb
碜	sxse
豗	sxse
㝾	sxsj
㞀	sxso
䪲	sxsw
㞄	sxsx
尰	sxtj
礙	sxtv
砪	sxu
㞉	sxuj
尲	sxuw
㝿	sxvv
尬	sxwr
㞂	sxwx
砒	sxx
礫	sxxd
磣	sxxe
䃈	sxxr
磯	sxxw
厷	sxy
大	sy
䂖	sy
䂴	sy
奩	syab
㚜	syak
奆	syav
奁	syaw
碚	syb
夻	syb
碻	sybb
䃄	sybi
碠	sybk
䃪	sybk
礅	sybt
䃷	syby
夯	syct
㚓	syd
㚞	sydd
䃺	sydn
礳	syds
厗	syf
㚏	syf
奔	syff
夲	syfg
礦	syfw
砇	syg
夺	sygy
砫	syh
套	syha
耷	syhd
㻎	syhh
㿴	syhv
砯	syio
奫	syir
夵	syiw
圶	syj
䂯	syj
郀	syjc
瓠	syje
奲	syjf
夳	syjg
奈	syji
奎	syjj
奢	syjn
刳	syjn
䃴	syjn
㥣	syjp
匏	syjq
鴮	syjq
㰭	syjq
夸	syjx
夽	syjx
綔	syjx
奇	sykb
㚡	sykb
㭐	sykd
剞	sykn
㓫	sykn
欹	sykq
鵸	sykq
䫑	syks
攲	sykv
敧	sykv
㿲	sykv
奯	sylt
奝	symb
㪺	symf
砊	symg
㚗	symh
䃶	symq
㞭	symx
奋	synb
䣍	sync
㣏	syne
䃥	synj
剦	synn
鹌	synq
奛	synq
鵪	synq
㪑	synv
奄	synx
碲	sypm
牵	sypt
磅	sypy
㕈	syq
㚚	syqb
奅	syqc
奓	syqq
奟	syqq
䲪	syqx
奃	syqy
夼	syr
夰	syr
奪	syrg
㚝	syrj
奞	syrl
奮	syrn
矿	sys
奤	sysj
奭	sysn
夶	sysy
㚐	sysy
䃚	sytt
䃠	sytv
㚒	syty
砬	syu
冭	syu
㕇	syu
羍	syuh
尞	syui
㚔	syuj
眘	syum
昚	syun
㶫	syuo
㚠	syuo
鹩	syuq
鷯	syuq
䙽	syuq
䨅	syur
硠	syv
磄	syvb
夿	syvn
䃵	syvq
㚕	syvr
郟	sywc
碎	sywf
㓨	sywn
㤲	sywp
磙	sywq
鵊	sywq
鷞	sywq
㰰	sywq
硛	sywr
頰	syws
䫪	syws
㪎	sywv
爽	syww
夾	syww
䂭	syww
㼽	sywy
㼪	sywy
䃙	syx
㚎	syxl
㚛	syxn
硫	syxr
硋	syxw
厺	syxy
砿	syxy
太	syy
盇	syym
态	syyp
奒	syyw
我	t
毛	ta
䇫	ta
毧	taas
箋	taat
㲓	taay
笸	tab
䈅	tabk
籄	tabm
筬	tac
範	tac
㲌	tacp
毽	tacv
毢	tadg
毝	tae
䉐	tafb
氁	tafs
乇	tag
毬	tagy
筐	tah
筺	tahy
㲑	taio
毜	taiw
䇪	taj
箴	takb
䉞	takp
箧	taks
笌	tal
毡	talb
覒	tamq
㲩	tanc
篚	tanf
毴	tanf
箌	tang
筪	tanp
毸	tanp
毯	taoo
簪	taqn
氇	taqn
毥	taqn
氌	taqn
毱	taqu
簐	taqw
㲝	tarl
篋	tasw
笺	tat
䇝	tat
䇳	tat
㲎	tata
簵	tatb
㯔	tatd
䄟	tatj
籃	tatm
㦌	tatp
毨	tatq
毳	tatt
㲮	tatw
毩	taud
氆	taun
㲧	tavl
䉯	tavm
熈	tavo
㷩	tavo
毺	tawn
䉖	tawp
㲐	tawv
毶	taxe
毪	taxt
㲱	taxx
毰	tayb
氊	tayk
㲙	tayr
各	tb
簂	tbak
筥	tbb
簞	tbbf
䉷	tbbt
䎊	tbcc
䇷	tbcn
㪾	tbek
箇	tbfb
筃	tbg
䇸	tbh
箿	tbhd
洜	tbio
筽	tbks
篑	tblm
簣	tblm
簬	tblt
筼	tbm
篔	tbm
鄅	tbmc
㙑	tbmj
禹	tbmy
㓢	tbng
㤩	tbpu
鵅	tbqx
兎	tbqy
雒	tbrl
頟	tbsw
箘	tbtd
敋	tbtw
䇱	tbtw
䇼	tbvn
笝	tbvy
气	tc
笳	tcb
笤	tcb
笥	tcb
㲷	tcbf
氤	tcbg
㲴	tcbl
氳	tcbm
氖	tccp
㔕	tcct
氥	tcdg
箛	tcex
氪	tcfq
氰	tchq
㲵	tciq
䉄	tcjt
氭	tcki
氫	tckj
氩	tckn
氬	tckn
氞	tckw
竾	tcl
㲶	tclo
㪂	tclv
氝	tcmw
氙	tcmx
氜	tcn
氱	tcne
刏	tcng
氠	tcnl
氲	tcnm
氮	tcoo
忥	tcpu
氨	tcpx
㰟	tcqw
氚	tcr
氘	tcr
籊	tcrl
鿫	tcrs
氕	tct
竻	tct
筳	tctj
筵	tctl
氡	tctu
氣	tcud
氧	tcuh
䉌	tcus
氯	tcvh
氢	tcvj
䈨	tcvq
氟	tcvr
氛	tcwc
篨	tcwt
気	tcwy
笈	tcy
氦	tcyw
禾	td
䉩	tdab
秷	tdaj
稢	tdak
稶	tdak
䄰	tdal
篐	tdam
䅾	tdan
䄾	tdas
秬	tdav
䄩	tday
和	tdb
㕿	tdb
稆	tdbb
稇	tdbd
䆆	tdbd
稒	tdbf
秵	tdbg
程	tdbh
种	tdbl
䅪	tdbm
惒	tdbp
䅰	tdbp
䅌	tdbq
稛	tdbt
积	tdbw
䉹	tdbw
䄦	tdc
䅄	tdcc
穋	tdce
季	tdck
秄	tdck
䄬	tdcl
秀	tdcp
䄧	tdcp
頺	tdcs
䅍	tdct
篥	tdd
箖	tdd
䄽	tddg
䅺	tddj
穗	tddp
穤	tdds
秿	tddu
䅘	tddw
秫	tddy
穑	tdfb
秙	tdfb
稘	tdfh
穁	tdfh
簯	tdfh
䈤	tdfj
䅿	tdfj
秆	tdfl
稙	tdfm
稓	tdfn
䅦	tdfn
秓	tdfv
穫	tdfv
稹	tdfw
穔	tdfw
䅩	tdfw
䅷	tdfw
䅴	tdfx
䅸	tdfy
䅒	tdfy
䇴	tdg
篿	tdgy
積	tdhm
稧	tdhs
稍	tdiq
䈾	tdiq
秒	tdit
秸	tdjb
穡	tdjb
穯	tdjb
秲	tdjg
篻	tdji
稑	tdjj
䅅	tdjj
䅲	tdjn
穘	tdjs
稜	tdjt
䄮	tdjw
秐	tdjx
䉙	tdjx
籈	tdjy
笨	tdk
秣	tdkd
䄯	tdkf
䄨	tdkg
稏	tdkn
稫	tdkn
䅀	tdkn
䅉	tdkn
穂	tdkp
秤	tdku
稉	tdkw
穪	tdkw
䄺	tdkw
䄼	tdkw
穲	tdky
秥	tdlb
䄳	tdll
穢	tdlt
箱	tdm
稠	tdmb
秱	tdmb
秃	tdmg
租	tdmh
穨	tdmm
簠	tdmn
盉	tdmn
䆀	tdmo
秽	tdmq
鵚	tdmq
䅐	tdmq
䆇	tdmq
颓	tdms
秧	tdms
穠	tdms
頽	tdms
䅱	tdmu
䆁	tdmu
䄲	tdmw
秈	tdmx
㟀	tdmx
䆉	tdmx
香	tdn
馢	tdna
馠	tdnb
䭲	tdnb
馚	tdnc
馞	tdnc
馟	tdnc
梨	tdnd
稞	tdnd
䉓	tdnd
簟	tdnf
稈	tdnf
利	tdng
䅞	tdng
䭱	tdni
䭰	tdnj
䅠	tdnl
䖽	tdnl
馧	tdnm
馩	tdnm
馪	tdnm
䭯	tdnm
䵩	tdnm
馡	tdnn
馫	tdnn
䅛	tdnn
秞	tdno
䱘	tdno
悡	tdnp
稩	tdnq
䅢	tdnq
鿟	tdnq
䫝	tdns
犁	tdnt
馥	tdnt
稷	tdnt
馝	tdnt
䄿	tdnt
穙	tdnu
馦	tdnu
䊬	tdnu
穝	tdnv
䅼	tdnv
穓	tdnw
鋫	tdnw
馤	tdnw
䅥	tdnw
㴝	tdnw
鿠	tdnw
馜	tdnx
馣	tdnx
䅙	tdnx
馛	tdny
醔	tdod
湬	tdoi
蝵	tdol
㡑	tdom
稥	tdon
愁	tdop
䵸	tdop
鶖	tdoq
鹙	tdoq
䄻	tdoq
䨂	tdor
揫	tdot
秋	tdow
鍫	tdow
媝	tdox
甃	tdoy
秺	tdpa
穃	tdpb
稨	tdpf
䅝	tdpj
䉘	tdpj
穦	tdpm
秾	tdpq
稼	tdps
穟	tdps
秘	tdpt
䆈	tdpt
䄴	tdq
秖	tdqa
剓	tdqc
棃	tdqd
禿	tdqg
称	tdqi
穄	tdqj
䖿	tdql
黧	tdqm
睝	tdqm
穞	tdqn
穭	tdqn
籕	tdqn
鯬	tdqo
稳	tdqp
䆋	tdqp
㥎	tdqp
移	tdqq
稝	tdqq
鵹	tdqq
䅋	tdqq
頹	tdqs
犂	tdqt
䴻	tdqt
䊍	tdqu
䅓	tdqv
黎	tdqw
錅	tdqw
穐	tdqx
穒	tdqx
䅳	tdqx
秇	tdqy
秪	tdqy
䄪	tdqy
穕	tdrd
穆	tdre
稗	tdrf
䅣	tdrh
稚	tdrl
籗	tdrl
䄸	tdrn
穛	tdro
籱	tdrr
秹	tdrt
穥	tdrw
䄷	tds
䅶	tdsg
秠	tdsk
嵇	tdsm
嵆	tdsm
稽	tdsn
稬	tdss
䆍	tdst
䅡	tdsw
䅖	tdsx
㛷	tdsx
秡	tdsy
諬	tdsy
秅	tdta
秏	tdta
穚	tdtb
䅂	tdtb
䈷	tdtb
䅎	tdtc
秝	tdtd
秊	tdtf
秊	tdtf
䄭	tdtf
秼	tdti
種	tdtj
䄵	tdtj
䅜	tdtk
秨	tdtl
秳	tdtm
穳	tdtm
䅨	tdtn
㷏	tdto
龝	tdtp
䅤	tdtr
秗	tdts
秭	tdtt
稪	tdtt
秩	tdtw
䅗	tdtx
㘒	tdtx
䅚	tduc
科	tduf
秚	tduj
䆅	tdum
䅬	tdum
剩	tdun
䅵	tduo
税	tduq
䅆	tduq
稊	tdut
稴	tduw
䆏	tduw
䆊	tduw
乘	tdux
稵	tdux
䅹	tdux
䅕	tdvf
䄫	tdvk
稰	tdvq
穊	tdvq
䄶	tdvr
稦	tdvt
穉	tdvt
䅏	tdvt
秛	tdvv
秜	tdvx
稺	tdvy
黏	tdwb
秴	tdwb
䅮	tdwb
稃	tdwc
秎	tdwc
䵘	tdwe
稐	tdwf
䄹	tdwf
䵕	tdwf
穱	tdwg
秂	tdwg
黍	tdwi
䵔	tdwi
䵛	tdwj
䆎	tdwk
稀	tdwm
稱	tdwm
稲	tdwn
䵒	tdwn
㓿	tdwn
䵗	tdwn
稔	tdwp
秢	tdwp
穏	tdwp
穩	tdwp
稅	tdwq
䵙	tdwq
稻	tdwr
䵚	tdwr
䵜	tdws
稌	tdwt
稯	tdwt
䵓	tdwt
箂	tdww
黐	tdwx
䅑	tdwx
䵑	tdwy
秮	tdxb
穇	tdxe
䅟	tdxe
委	tdxk
䅔	tdxn
䭳	tdxn
覣	tdxq
魏	tdxr
稭	tdxr
䫋	tdxs
犩	tdxt
稄	tdxt
穖	tdxw
秕	tdxx
私	tdxy
瓾	tdxy
䅊	tdya
稿	tdyb
稖	tdyb
䅯	tdyb
稕	tdyc
䄱	tdyc
稡	tdyf
稤	tdyi
穅	tdyi
䅫	tdyi
穜	tdyj
䆄	tdyk
秔	tdym
稸	tdyn
䅧	tdyn
穮	tdyo
穰	tdyq
穣	tdyq
穧	tdyr
䆂	tdyu
稂	tdyv
穬	tdyw
䅻	tdyx
䅭	tdyy
筕	teg
笊	tei
簁	tell
篪	telm
䉠	temt
䈲	temv
篽	tetc
籞	tetj
箻	tevl
篵	tewl
笟	tex
升	tf
䇢	tfb
䈽	tfbh
簕	tfct
㔓	tfct
簙	tfdg
簛	tfek
郵	tffc
垂	tffk
䳠	tffq
㩾	tffv
甀	tffy
千	tfg
箕	tfh
簊	tfj
䇞	tfj
竿	tfl
篝	tfmj
䈯	tfmw
簳	tfnf
籖	tfnk
簧	tfnw
忎	tfpu
箶	tfq
䉈	tfqt
篏	tfqw
臿	tfrj
歃	tfrq
敮	tfrv
籆	tfrv
箬	tfsb
䈒	tfu
㔞	tfuc
埀	tfuj
㪓	tfuv
乖	tfux
簸	tfvv
笹	tfx
䈎	tfxd
䉇	tfxn
手	tg
䖸	tgal
箍	tgam
鹅	tgaq
鵝	tgaq
鵞	tgaq
我	tgat
筘	tgb
箉	tgbc
䉗	tgbh
劧	tgct
䇽	tgek
箝	tgfj
簼	tgfm
簎	tgfn
龵	tgii
䈰	tgiq
拜	tgkh
籒	tgkn
看	tgm
籜	tgmu
籀	tgqn
篺	tgrf
䉥	tgrp
䉟	tgrv
掱	tgtt
箨	tgvj
筢	tgvn
掰	tgwt
搿	tgwt
籡	tgww
生	th
䇯	thd
筭	thf
籍	thfn
筹	thgy
篲	thhv
筙	thi
眚	thm
箦	thmw
簀	thmw
箺	thn
甥	thnc
箐	thq
㔟	thqc
䲼	thqx
甡	thth
甧	thtq
㽓	thtt
箃	thvy
䉁	thwp
竹	ti
笵	tic
䈃	ticb
筂	ticl
䉎	tid
簿	tidg
䈬	tidu
䇵	tiek
篊	tifw
丿	tiii
䈌	timh
䈋	tin
簹	tinb
簜	tine
篞	tinj
筲	tiq
箾	tiqn
箔	tirn
箵	titm
箲	titq
筜	tivh
箥	tivv
簗	tiwd
籓	tiwn
箈	tixb
告	tj
籉	tjba
郜	tjc
筇	tjc
笻	tjc
䎋	tjcc
勂	tjct
竺	tjg
等	tjgy
㦵	tjia
邾	tjic
壬	tjii
㐄	tjii
鼄	tjip
鴸	tjiq
朱	tjiw
㼡	tjiy
筀	tjj
篈	tjjg
笁	tjl
築	tjmd
制	tjmn
䱥	tjmo
製	tjmq
掣	tjmt
篫	tjmt
篢	tjmw
𬕂	tjmw
筑	tjmy
箸	tjn
靠	tjnf
酂	tjqc
酇	tjqc
䢾	tjqc
先	tjqg
笎	tjqg
赞	tjqm
贊	tjqm
劗	tjqn
㬱	tjqn
兟	tjqq
㰫	tjqq
㪇	tjqt
筠	tjqu
鹄	tjqx
鵠	tjqx
勧	tjrc
䧼	tjrl
歓	tjrq
観	tjrq
頶	tjsw
䉅	tjuy
籌	tjvg
簭	tjwb
䉢	tjwb
劮	tjwc
失	tjwg
簮	tjwn
怣	tjwp
鴩	tjwq
䈊	tjwt
筮	tjww
䇭	tjx
篕	tjxm
丢	tjxy
午	tk
䉔	tkaa
笴	tkb
䇿	tkbi
籁	tkbm
籟	tkbm
䈏	tkbn
簌	tkbq
䈪	tkbu
䇺	tkbu
䇧	tkbw
乞	tkcg
㐌	tkcl
刉	tkcn
㩿	tkct
笄	tkf
鄦	tkfc
橆	tkfd
乗	tkfi
剰	tkfn
無	tkfo
鷡	tkfq
舞	tkft
甒	tkfy
竽	tkg
尓	tkiw
玍	tkj
啎	tkkb
乍	tklg
䇥	tkll
篶	tklo
怎	tklp
䈣	tklt
勳	tkmc
策	tkmi
箣	tkmn
熏	tkmo
䇤	tkmw
籭	tkmy
動	tknc
重	tknj
濌	tknn
㔐	tknn
勲	tkno
憅	tknp
䳯	tknq
㰱	tknq
复	tknt
筻	tknw
幷	tksf
筓	tksf
甁	tksy
年	tktj
鵇	tktq
䇲	tkus
秉	tkvi
箑	tkvl
籋	tkww
勄	tkxc
瀪	tkxi
㶗	tkxi
鳘	tkxk
䇘	tkxk
鰵	tkxo
慜	tkxp
毓	tkxr
敏	tkxt
每	tkxu
毎	tkxu
繁	tkxx
緐	tkxx
䌓	tkxx
䋣	tkxx
牛	tl
䖝	tl
㹑	tlam
牫	tlat
吿	tlb
笘	tlb
㸶	tlbg
牠	tlcl
㸾	tlcp
牞	tlct
犍	tlcv
牣	tlcy
牺	tldg
㹘	tlds
㸸	tleb
㸫	tlek
牯	tlfb
㹀	tlfc
㹏	tlfh
㸩	tlfl
犆	tlfm
犕	tlfm
犊	tlfs
牜	tlii
牡	tlj
㸵	tljb
特	tljg
㹗	tljg
犢	tljm
㸿	tljq
㹓	tljs
牾	tlkb
牱	tlkb
牼	tlkj
㹔	tlkk
㸬	tlkm
㹛	tlkt
䇛	tll
箎	tlmg
犅	tlmm
牭	tlmn
犑	tlms
䈛	tlmv
犋	tlmw
㸽	tlmw
犤	tlmx
䈇	tlnf
犦	tlni
籚	tlnm
牰	tlno
㹄	tlnt
㹒	tlnu
簴	tlnw
㹇	tlnw
㹎	tlnx
㹚	tlob
㹙	tlom
㹆	tlpa
犗	tlpb
牸	tlpc
犏	tlpf
㹊	tlpr
㸰	tlpx
物	tlqe
觕	tlqm
惣	tlqp
㹅	tlqp
鿯	tlqu
犓	tlqx
牴	tlqy
㸪	tlr
㹋	tlre
犄	tlsb
牻	tlse
㹉	tlsi
犡	tlsy
牦	tlta
犞	tltb
㸱	tltc
犐	tltf
牲	tlth
㸼	tlth
牿	tltj
牪	tltl
㸲	tltl
牬	tltt
犇	tltt
犔	tltu
牧	tltw
犠	tlua
犧	tlua
犈	tluc
㸯	tluf
䍧	tluh
㹖	tlus
犪	tlut
㸭	tlvn
犌	tlvv
㸮	tlwc
㸹	tlwg
牷	tlwh
㸳	tlwp
牝	tlx
犙	tlxe
㸨	tlxl
㸻	tlxt
牳	tlxu
犣	tlxx
牤	tlya
犒	tlyb
犃	tlyb
牥	tlyc
犉	tlyc
㹍	tlyf
㹁	tlyi
犝	tlyj
牨	tlym
犥	tlyo
犜	tlyt
㹌	tlyt
舌	tm
簚	tmam
篾	tmay
䍉	tmbw
卸	tmc
卹	tmc
缷	tmc
䘏	tmc
䣃	tmc
筯	tmct
㔚	tmct
衂	tmcy
罈	tmdf
缽	tmdk
缿	tmeb
衇	tmeq
算	tmf
䑜	tmfd
甜	tmfj
筁	tmfk
䈀	tmfn
㔍	tmfn
䍎	tmfo
憇	tmfp
罐	tmfr
衊	tmfy
凢	tmg
笡	tmh
衈	tmhd
缶	tmii
衆	tmio
篎	tmit
罉	tmit
甪	tmj
簓	tmje
缸	tmjl
睾	tmju
筒	tmkb
䍂	tmkg
舔	tmki
䍈	tmku
缻	tmky
币	tml
䍄	tmlb
罏	tmlm
罅	tmlu
笜	tmm
舑	tmmj
䑙	tmmj
笧	tmmk
罁	tmmm
籰	tmmv
簤	tmmw
血	tmn
笽	tmn
舓	tmne
刮	tmng
䈟	tmng
㓡	tmng
罎	tmnx
舕	tmoo
罀	tmoq
缹	tmow
䍆	tmpk
䘔	tmpt
䉚	tmpy
䑚	tmq
舐	tmqa
笕	tmqg
筧	tmqg
䘓	tmqr
欫	tmqw
欰	tmqw
缼	tmqw
鸹	tmqx
鴰	tmqx
箩	tmqy
舚	tmqy
䑛	tmqy
憩	tmrp
篹	tmsc
衃	tmsl
篅	tmsm
䵵	tmsm
頢	tmsw
䉵	tmsw
篡	tmsx
纂	tmsx
簒	tmsx
籑	tmsy
䇦	tmsy
衉	tmtb
䍋	tmtk
䍇	tmtp
舙	tmtt
敌	tmtw
缾	tmuf
罇	tmug
衅	tmuj
䈑	tmvb
衄	tmvf
缺	tmvw
筫	tmw
䘐	tmwc
笍	tmwg
䍅	tmwp
箆	tmwx
乱	tmx
屲	tmx
舏	tmxl
罆	tmxm
籮	tmxr
䘒	tmxt
竼	tmy
䍌	tmyb
辞	tmyf
䘑	tmyi
䉰	tmyw
䍊	tmyw
甶	tnb
䈳	tncc
篳	tnfj
筸	tnfl
笪	tnk
䈕	tnkl
筛	tnkm
箅	tnkr
䉪	tnnn
笛	tno
笚	tnp
䈓	tnqw
篂	tnth
篮	tntm
䉂	tnx
䇩	tnxt
箟	tnxx
簩	tooc
筄	toqg
䈐	toso
筷	tovw
乏	tp
䉱	tpab
簄	tpbv
笾	tpct
筞	tpd
䉦	tpdv
簺	tpfj
箜	tpjl
筦	tpjq
簆	tpjv
箮	tpkk
䇡	tpkl
籧	tpls
簻	tpmb
篇	tpmf
䈿	tpnw
䈼	tppm
箢	tpqc
鴔	tpqx
篧	tprl
䈹	tprn
籩	tpry
篴	tpse
䈆	tpsu
䶰	tpta
篷	tpth
簉	tptj
管	tpv
簶	tpvh
䈶	tpwb
龜	tpx
笱	tqb
䉧	tqcn
筋	tqct
䉏	tqct
䈥	tqct
䇟	tqct
箙	tqcv
䈻	tqdu
笏	tqe
䈡	tqep
䉉	tqex
䇶	tqm
筍	tqn
箰	tqnc
䉳	tqou
簲	tqrf
篼	tqrq
簷	tqsy
䇖	tqt
笷	tqtc
笉	tqu
䈸	tquf
籐	tqui
籘	tqux
笣	tqv
筝	tqvl
䈈	tqvn
䇜	tqw
䉆	tqx
篘	tqxx
笂	tqy
筏	trat
笩	tray
䈭	trb
筗	trbl
箄	trfg
符	trgy
篁	trh
篟	trhq
箯	trkw
籅	trkw
篠	trld
䇚	trlg
筱	trlt
䉣	trqo
簰	trrf
䉶	trrv
䇮	trtj
筰	trtl
䉛	trus
篌	trvt
䈜	trvv
篗	trvy
篦	trwx
䈗	trxt
矢	ts
榘	tsad
矩	tsav
知	tsb
呑	tsb
喬	tsbb
勪	tsbc
䎗	tsbc
䣽	tsbd
聟	tsbh
䀉	tsbm
䝷	tsbm
智	tsbn
鼅	tsbp
䵹	tsbp
鷮	tsbq
䚐	tsbq
敿	tsbt
㲛	tsbt
敽	tsbv
䢴	tsc
䂏	tscb
矪	tseu
矱	tsfv
圱	tsj
䂒	tsjb
䂔	tsju
短	tsku
䂑	tslx
䂐	tsmm
䂓	tsmq
岙	tsmx
矲	tsmx
刋	tsng
鴁	tsqx
鴙	tsqx
乔	tsr
雉	tsrl
笼	tst
籠	tst
矯	tstb
矫	tstr
矨	tsts
矮	tstx
簝	tsui
矰	tsun
矧	tsvl
叐	tsvy
谸	tswb
矬	tswj
筴	tsww
䂕	tsxs
夭	tsy
笔	tta
笿	ttb
筿	ttd
箠	ttfk
䉑	ttfo
笙	tth
䇬	ttiw
筶	ttj
箽	ttkj
笮	ttlg
筈	ttm
筣	ttng
篍	ttow
筅	ttqg
籫	ttqm
簃	ttqq
䉫	ttqw
䉜	ttrl
笶	tts
簥	ttsb
笑	ttsy
䆌	ttsy
䇨	tttj
笗	ttu
䈖	ttuf
篩	ttvm
笫	ttxt
乊	tu
箞	tuc
乥	tucg
乯	tucg
䈂	tuf
乎	tuk
籣	tuki
䉕	tumn
简	tun
簡	tun
箪	tunf
䉍	tupu
箭	tuqn
䉮	turl
㸔	tusm
䉝	tuta
䈴	tuw
篓	tuxk
簍	tuxk
籔	tuxt
䉤	tuxt
䈘	tuxx
簢	tuyg
笃	tv
篤	tv
笢	tvag
箼	tvaj
節	tvc
蠞	tvcl
阜	tvfg
䘀	tvfl
顊	tvfs
箓	tvh
䇰	tvik
篜	tvio
箫	tvir
䈄	tvix
䈔	tvjv
師	tvkm
簦	tvku
䉲	tvkw
筆	tvl
蛗	tvl
䇙	tvl
歸	tvlm
簫	tvlr
第	tvlt
篃	tvm
筩	tvmj
帥	tvml
簋	tvmn
峊	tvmx
笆	tvn
箒	tvpm
䈝	tvq
鴭	tvqx
笰	tvr
頧	tvsw
笋	tvt
䇻	tvta
䇹	tvtb
簈	tvtf
箳	tvuf
簘	tvur
篛	tvuu
㷗	tvvo
簨	tvvw
䦾	tvxq
籛	twaa
篯	twat
答	twb
籥	twbf
籨	twbq
籲	twbs
籢	twbt
簽	twbw
筟	twck
务	twct
条	twd
㣊	twe
筌	twh
夆	twhl
㶻	twho
攵	twii
夂	twii
夊	twii
签	twik
䈩	twin
䇣	twiw
㚅	twkt
䈠	twkv
咎	twlb
处	twlg
昝	twln
㰶	twlq
䈁	twmf
処	twmg
䉒	twn
备	twnb
劄	twng
箚	twng
惫	twnp
笭	twp
䈱	twrj
筡	twt
夅	twtj
籦	twtj
籂	twtm
䈧	twto
冬	twu
㐑	twuc
夈	twud
螽	twul
䶱	twup
䳉	twuq
䧷	twur
篒	twv
籙	twvh
箏	twvl
籤	twwk
笅	twwy
䈵	twxc
䈦	twxt
䇗	twxy
筨	twyb
篬	twyb
笒	twyv
系	tx
笞	txb
筎	txb
䈢	txbd
䈚	txbp
䉭	txbx
笲	txf
䈙	txgy
䪢	txlk
䪠	txlk
䪡	txlk
䙻	txlq
䈫	txmw
箹	txqy
䉊	txsa
篆	txse
䉃	txsg
䈺	txtu
籎	txtv
簖	txue
䉋	txvm
笯	txvy
笓	txx
篸	txxe
籪	txxe
筚	txxf
么	txy
笖	txyw
入	ty
䇾	ty
笀	tya
箁	tyb
篙	tybb
篰	tybc
䉡	tybk
䈞	tybn
簑	tybq
䉴	tybq
籇	tybs
籝	tyby
籯	tyby
㐈	tycg
䓥	tyff
簱	tyfh
䉀	tyfo
䇠	tyh
汆	tyio
㒰	tyjl
簔	tykq
兪	tykx
笇	tylg
䈍	tym
笐	tymg
㠳	tyml
㒴	tymm
肏	tymw
屳	tymx
㒲	tyn
篭	tynx
篣	typy
䈮	tyqb
鳰	tyqx
鷑	tyqx
㒱	tyqy
䉨	tysm
簅	tyst
箷	tytc
籏	tytf
簇	tytt
笠	tyu
籴	tyud
糴	tyur
䨀	tyur
簾	tyuw
筤	tyv
篖	tyvb
䉬	tyvm
箤	tywf
籬	tywr
箊	tywu
筊	tyww
篱	tywx
簏	tyx
䈉	tyxk
䉸	tyyy
为	u
㭍	uad
㾝	uaf
冻	uaiw
痓	uaj
疟	uak
减	uakb
㓕	uako
冴	ual
疨	ual
㿊	uaqn
㿄	uatm
㓒	uawi
痐	ubb
㾔	ubb
㿋	ubbd
癉	ubbf
癌	ubbm
痼	ubfb
凅	ubfb
冲	ubl
㿉	ublm
总	ubpu
㾓	ubq
况	ubqg
疻	ubw
疗	uc
疖	uc
兯	uc
痂	ucb
瘸	ucbw
疡	uce
痾	uckb
疓	ucp
瘾	ucqp
㿑	ucrl
㿇	ucrn
癃	uctt
瘳	ucwe
癮	ucwp
㾻	ucwt
癊	ucwx
为	ucy
㽺	ucy
米	ud
䤋	udak
糮	udam
糣	udan
粔	udav
糰	udbg
籸	udcf
㐘	udcg
籽	udck
䊮	udcr
䊕	udcv
籾	udcy
痳	udd
凓	udd
痲	udd
䊤	uddf
粞	uddg
糐	uddg
䊜	uddg
凚	uddj
𥻗	uddk
糯	udds
䊇	uddu
䉼	udek
粄	udev
䊀	udfb
籵	udfg
粸	udfh
糷	udfi
粓	udfj
糚	udfj
糒	udfm
糊	udfq
糢	udfs
䊔	udfs
糤	udft
䊖	udfu
粪	udfw
粠	udfw
䊣	udfw
糀	udfx
糂	udfx
䊟	udfy
䊪	udfy
鷷	udgq
尊	udgy
籿	udgy
粻	udha
精	udhq
䊑	udib
糛	udij
粆	udit
凐	udj
糦	udjb
䊭	udjg
瘭	udji
䉺	udjl
䊦	udju
粩	udjx
酋	udk
㾞	udk
粖	udkd
䊂	udki
糟	udkn
粳	udkw
粀	udkw
粘	udlb
蠤	udll
粡	udmb
粬	udmf
籶	udmg
粗	udmh
㾴	udmh
糬	udmj
粣	udmk
䊃	udmm
䊫	udmn
粯	udmq
糫	udmq
籼	udmx
畨	udnb
癗	udnb
粿	udnd
糃	udne
粴	udnj
糧	udnj
䊓	udnl
粙	udno
䊘	udnq
䊡	udnv
糞	udnw
䊐	udnx
䊏	udoo
㷕	udow
䊉	udpd
糄	udpf
粽	udpj
糘	udps
糙	udpt
粐	udpv
䊚	udpv
䉻	udqa
䊅	udqb
翷	udqc
鄰	udqc
斴	udqe
粅	udqe
粋	udqf
㔂	udqn
䚏	udqq
粦	udqt
粷	udqu
粼	udqx
亃	udqx
甐	udqy
粺	udrf
䊗	udrh
癨	udrl
䊒	udrl
粕	udrn
糗	udrs
糇	udrt
粝	udsc
鄭	udsc
糆	udsj
糎	udsj
粫	udsm
粨	udsn
類	udss
糥	udss
猷	udsu
頪	udsw
类	udsy
奠	udsy
粏	udsy
糲	udsy
㽀	udsy
籷	udta
粍	udta
籺	udtc
粚	udtc
粁	udtf
糌	udtn
䊁	udtq
䉿	udtu
敉	udtw
䊴	udtw
䊈	udtx
痡	udu
䊎	uduc
料	uduf
䉽	uduj
糋	udun
糕	uduo
糍	udux
糅	udvd
粈	udvf
粶	udvh
糨	udvl
粌	udvl
糔	udvl
䊧	udvm
粑	udvn
糈	udvq
糏	udvq
䊥	udvr
䊊	udvt
糑	udvu
粎	udvy
粭	udwb
粉	udwc
粰	udwc
䊱	udwk
䊛	udwm
糩	udwn
䊩	udwn
䊝	udwp
㥹	udwp
糉	udwt
糭	udwt
㾢	udww
凇	udwx
䣚	udxc
糁	udxe
糝	udxe
㪹	udxf
䊋	udxj
娄	udxk
婁	udxk
籹	udxk
鷜	udxq
纇	udxs
颣	udxs
䫫	udxs
数	udxt
數	udxt
氀	udxt
粃	udxx
甊	udxy
㾁	udy
糖	udyb
粹	udyf
䊞	udyf
糠	udyi
粧	udyj
䊰	udyj
粇	udym
䊳	udyn
糡	udyq
粒	udyu
粮	udyv
䊯	udyw
麊	udyx
䊌	udyx
㾠	ueh
㿅	uell
㾷	uelm
癓	uemt
癥	uemt
瘢	uemv
癁	uett
㽹	uevy
瘲	uewl
㽿	uex
㽽	ufb
㪳	ufb
瘽	ufbh
癱	ufbr
㖍	ufbx
乧	ufcg
凘	ufek
瘔	uffb
㿎	uffm
斗	ufg
疳	ufj
癫	ufms
癲	ufms
瘨	ufmw
瘄	ufn
瘼	ufns
癀	ufnw
癘	ufny
痨	ufpc
㾰	ufq
㿃	ufqm
㓓	ufu
㪲	ufv
㽻	ufvy
㓋	ufw
瘩	ufwb
疶	ufx
瘎	ufx
疛	ugy
羊	uh
痮	uha
羬	uhab
䍼	uhan
羢	uhas
䍰	uhbg
䍺	uhbp
翔	uhcc
瘛	uhcp
瘈	uhcs
劷	uhct
㓗	uhcx
䍸	uhdg
羺	uhds
羏	uhe
羵	uhfm
兰	uhg
羨	uhiq
䡨	uhja
差	uhjl
齹	uhjl
㷢	uhjo
㿷	uhjv
䍪	uhkd
䍶	uhki
羥	uhkj
䍨	uhkm
凑	uhks
䍬	uhku
羠	uhkw
着	uhm
盖	uhmn
羰	uhmo
羖	uhmv
羯	uhnw
䍮	uhoq
羹	uhos
䫞	uhos
羔	uhow
羙	uhow
羮	uhow
羫	uhpj
羜	uhpk
羦	uhpq
恙	uhpu
䍫	uhpx
凊	uhq
䍯	uhqc
鲝	uhqk
䍵	uhql
鮺	uhqo
鯗	uhqo
鴹	uhqx
㕗	uhqx
羝	uhqy
羑	uhqy
养	uhr
䍲	uhrq
䍹	uhrs
羱	uhsi
䍽	uhsl
美	uhsy
羲	uhta
義	uhta
䣡	uhtc
䴊	uhtq
㾲	uhtw
䍩	uhtw
䍴	uhtx
善	uhub
鄯	uhuc
㿀	uhuh
羡	uhuq
歚	uhuq
敾	uhut
羴	uhuu
㪨	uhuv
羞	uhvf
羟	uhvj
羓	uhvn
羛	uhvr
䍷	uhvt
䍳	uhvv
䍻	uhvw
羒	uhwc
羭	uhwn
羳	uhwn
羚	uhwp
䍱	uhwt
羷	uhww
羌	uhx
姜	uhxk
羧	uhxt
䍭	uhxu
羗	uhxx
鿑	uhy
㔦	uhyc
癍	uhyh
羕	uhyi
羶	uhyk
羻	uhyt
羪	uhyv
養	uhyv
譱	uhyy
疒	uiii
冫	uiii
丷	uiii
痧	uiit
冰	uio
㽷	uio
痟	uiq
㾪	uitm
半	uj
㽵	uj
卷	ujc
勌	ujcc
痚	ujck
㓬	ujcn
券	ujco
劵	ujct
桊	ujd
叛	ujev
痔	ujgy
龹	ujii
㾏	ujj
䄅	ujji
冮	ujl
疘	ujl
䖭	ujl
齤	ujlw
眷	ujm
帣	ujml
凟	ujmm
瘏	ujn
判	ujng
鵥	ujnq
痣	ujpu
鲞	ujqk
觠	ujqm
鮝	ujqo
㿐	ujqq
奍	ujr
豢	ujse
頖	ujsw
䅈	ujtd
拳	ujtg
牶	ujtl
㪵	ujuf
㓑	ujuj
駦	ujv
㿒	ujvg
巻	ujvk
韏	ujvt
弮	ujvx
㓐	ujwj
凌	ujwt
餋	ujwv
鿛	ujww
疞	ujx
絭	ujx
勬	ujxc
㾡	ujxc
㾀	ujxy
誊	ujy
飬	ujyv
疴	ukb
凁	ukbi
癞	ukbm
癩	ukbm
瘌	ukbn
瘶	ukbq
瘷	ukbt
痘	ukbu
疠	ukct
并	ukf
剙	ukfc
郱	ukfc
㔙	ukfc
㤣	ukfp
鵧	ukfq
頩	ukfs
艵	ukfv
瓶	ukfy
剏	ukfy
㽳	ukg
兿	ukgx
䒑	ukii
疔	ukl
㓅	ukl
疜	uklg
症	ukll
夔	uklt
㾊	ukmi
病	ukmw
㿛	ukmy
冽	ukng
㾐	ukng
凍	ukni
㠮	uknj
普	uknn
癅	uknn
癋	uknp
痖	uknu
並	uknu
瘂	uknu
㾘	uknw
剪	ukqc
翦	ukqc
㮍	ukqd
前	ukqn
煎	ukqo
馘	ukrk
首	ukrm
䭭	ukrs
郑	uksc
关	uksy
瘗	ukuj
痦	ukvb
痍	ukvw
凄	ukvx
蠲	ukwl
益	ukwm
鷁	ukwq
鹢	ukwq
䚊	ukwq
㽴	ukwy
㽲	ukx
孳	ukxc
槊	ukxd
塑	ukxj
痙	ukxj
冱	ukxk
屰	ukxl
慈	ukxp
愬	ukxp
朔	ukxq
鹚	ukxq
欮	ukxq
鶿	ukxq
鷀	ukxq
兹	ukxx
甆	ukxy
丫	ul
痋	ul
瘧	ulak
痁	ulb
㾎	ulck
丬	ulii
㾟	ulit
壮	ulj
装	uljq
㾥	ulkv
㿖	ulnm
酱	ulqd
桨	ulqd
将	ulqg
浆	ulqi
螀	ulql
奖	ulqs
状	ulsu
醤	ulwd
奨	ulws
疵	ulx
㾹	ulxd
㾚	ulxj
妆	ulxk
㾇	um
癑	umfs
痶	umfw
疽	umh
㿂	umht
弊	umif
鳖	umik
蹩	umil
蟞	umil
瞥	umim
幣	umim
暼	umin
瘝	umio
鱉	umio
憋	umip
鼈	umip
龞	umip
鷩	umiq
䳤	umiq
䨆	umir
獘	umis
敝	umit
撆	umit
彆	umiv
鄨	umiv
鐅	umiw
㡀	umiw
斃	umix
嫳	umix
䌘	umix
痈	umj
癦	umj
㾆	umj
凋	umjb
凙	umju
痌	umkb
㓊	umkb
癏	umkq
凒	umku
㽾	umm
癯	ummr
㿙	umms
瘿	ummx
癭	ummx
曾	umn
鄫	umnc
䎖	umnc
朆	umne
㣒	umne
䒏	umnv
甑	umny
㾶	ump
凗	umrl
瘋	umtl
疫	umv
瘑	umvb
㓏	umwb
疯	umwy
疝	umx
㿚	umxr
㾧	und
痱	unf
郸	unfc
单	unfg
㓖	unfj
冁	unfq
兾	unfw
㾖	unj
疸	unk
兽	unkb
瘍	unke
㾯	unkq
痹	unkr
痩	unlv
瘟	unmn
曽	unn
㿔	unnn
癳	unnx
㾄	uno
䝉	unps
痬	unqe
瘰	unx
㿘	uoob
癆	uooc
痰	uoow
疢	uow
瘠	uowq
门	up
瘒	upaf
閳	upaf
阈	upak
閾	upak
閕	upal
䦯	upat
问	upb
問	upb
闾	upbb
閭	upbb
闆	upbb
阃	upbd
閫	upbd
闡	upbf
闠	upbm
阓	upbm
䰘	upce
閮	upct
闲	upd
閑	upd
䦥	updd
閪	updg
闉	updj
𬮱	updj
鹇	updq
鷴	updq
闄	updx
闬	upfl
閈	upfl
䦫	upfs
闀	upfv
阗	upfw
閧	upfw
闐	upfw
鬨	upfw
闭	upgt
閉	upgt
闰	uph
閏	uph
闻	uphd
聞	uphd
闫	uphg
閆	uphg
䦮	uphn
䦬	uphs
閠	uphy
䦞	upih
門	upii
鬥	upii
闛	upij
闣	upin
閖	upio
阔	upit
閯	upit
闊	upit
䦢	upix
䦌	upj
䦖	upjb
闱	upjc
䦙	upjg
闺	upjj
閨	upjj
㾤	upjl
阖	upjm
闔	upjm
闍	upjn
阇	upjn
闚	upjq
䦎	upjq
䦝	upjw
闩	upk
閂	upk
閜	upkb
䦜	upkb
開	upkf
闘	upkg
鬪	upkg
阑	upki
闌	upki
䦨	upki
閅	upkl
閇	upkl
閸	upkn
閛	upku
䦵	upkw
闽	upl
閩	upl
䦓	uplb
㾫	upmf
闏	upml
闤	upmq
阛	upmq
阒	upms
闃	upms
闝	upmt
䦩	upmt
闓	upmu
闦	upmu
䦴	upmu
闿	upmv
闅	upmv
閴	upmw
閊	upmx
间	upn
間	upn
闒	upnc
阘	upnc
鬬	upne
鬭	upne
䦔	upnk
阊	upnn
閶	upnn
闸	upnp
閘	upnp
覸	upnq
鷼	upnq
凕	upnw
䦪	upnw
閺	upny
䦸	upny
焛	upow
闙	uppb
闧	uppq
闼	upps
閟	uppt
闙	uppt
闷	uppu
悶	uppu
闥	uppu
䦡	uppv
閒	upq
㽸	upqg
䦛	upql
䦶	upql
阍	upqn
閽	upqn
覵	upqq
鷳	upqq
阎	upqr
閻	upqr
阄	upqx
䦰	upqx
䰗	upqx
䦲	upqy
阀	upra
閥	upra
闑	uprd
𫔶	uprd
闎	upri
閰	uprj
閵	uprl
阋	uprq
鬩	uprq
䦧	uprq
䦒	ups
䦠	upse
阉	upsx
闳	upsx
閎	upsx
閹	upsx
閁	upt
閐	upta
阁	uptb
閣	uptb
䦍	uptc
䦐	uptg
䦗	uptm
䦚	uptm
䦭	uptn
鬮	uptp
㾽	uptv
闂	upuc
阐	upuf
閗	upuf
鬦	upuf
䦕	upuf
闁	upup
阅	upuq
阙	upuq
閲	upuq
闕	upuq
関	upus
闯	upv
痯	upv
闖	upv
䦘	upvq
㾼	upvq
阕	upvs
闋	upvs
阚	upvt
闈	upvt
闞	upvt
鬫	upvt
䦤	upvv
䦑	upvw
闢	upvy
䦦	upw
閤	upwb
闟	upwc
闪	upwg
閃	upwg
閄	upwg
䦟	upwj
䦷	upwj
䦱	upwo
閝	upwp
閱	upwq
䦏	upwr
阌	upwv
閿	upwv
閦	upww
㾃	upx
䦳	upxc
閞	upxf
闗	upxo
關	upxx
訚	upy
誾	upy
䦣	upyb
閍	upyc
闵	upyg
閔	upyg
闹	upym
闶	upym
閙	upym
鬧	upym
閌	upym
闇	upyn
阏	upyu
閚	upyu
閼	upyu
阆	upyv
閬	upyv
阂	upyw
閡	upyw
兑	uq
疧	uqag
痻	uqan
疷	uqay
咨	uqb
痀	uqb
楶	uqbd
凂	uqbq
乲	uqcg
瘤	uqcn
㿍	uqct
栥	uqd
疩	uqfg
垐	uqj
瘵	uqji
癣	uqku
瓷	uqky
䬇	uqml
盗	uqmn
痪	uqms
瘓	uqms
资	uqmw
資	uqmw
癬	uqou
恣	uqpu
痭	uqq
䳐	uqqx
痑	uqqy
䫄	uqsw
癚	uqsy
秶	uqtd
敚	uqtw
粢	uqud
疱	uqv
净	uqvl
次	uqw
餈	uqwv
姿	uqxk
疚	uqy
瘣	urb
㾋	urd
凖	urfg
痺	urfg
㓔	urgy
㾈	urgy
㾮	urh
准	url
痽	url
癄	urow
瘜	urpu
㿁	ursf
瘊	urvt
瘦	urvy
㕠	urvy
癟	urwf
㿜	urwf
瘐	urwg
瘪	urwx
癙	urxg
㓈	us
痞	usb
疬	usct
瘃	use
痝	use
㒸	use
㾨	uskb
㾍	usm
痷	usnx
痏	usq
癧	ustl
療	usui
冹	usvy
瘞	uswj
㿓	uswl
瘱	uswp
㾜	usww
疣	usx
头	usy
凞	utao
痴	utb
疙	utcg
痵	utck
㾩	utfu
癪	uthm
瘇	utkj
痄	utlg
㓉	utm
痜	utmg
痸	utmn
㿗	utms
痢	utng
㾭	utow
疺	utp
冼	utqg
㾌	utqg
疾	uts
㓇	utsy
疼	utu
癤	utvc
痿	utxk
㾅	utxt
痗	utxu
㿆	utyq
痫	uud
痒	uuh
冸	uuj
瘥	uujl
癎	uun
瘅	uunf
痥	uuq
癇	uuq
㿕	uuqr
㾳	uuqx
㾾	uuw
瘘	uuxk
瘻	uuxk
瘚	uuxq
癢	uuyv
冯	uv
馮	uv
㾺	uv
冺	uvag
癖	uvby
瘺	uvdo
癜	uvfm
慿	uvfp
瘬	uvha
㵗	uvio
痉	uvj
㾱	uvjq
瘕	uvjv
㽶	uvk
冿	uvl
弚	uvl
㽼	uvl
剃	uvln
鹈	uvlq
鵜	uvlq
䶏	uvlr
弟	uvlt
凴	uvmg
痛	uvmj
疤	uvn
帰	uvpm
憑	uvpu
㓎	uvpv
㾛	uvpv
痕	uvq
疿	uvr
瘫	uvrl
㿏	uvtu
疲	uvv
癈	uvvm
為	uvvo
决	uvwg
疦	uvwg
痆	uvx
瘙	uvyl
兼	uw
凎	uw
㾣	uw
冾	uwb
㾑	uwb
㿌	uwbw
疮	uwc
疹	uwe
痊	uwh
㓌	uwh
㝺	uwit
甉	uwky
㪠	uwlv
癐	uwmn
冷	uwp
㾉	uwp
瘉	uwqn
癒	uwqp
歉	uwqw
鹣	uwqx
鶼	uwqx
瘹	uwqy
疥	uwr
㾙	uwsm
䫡	uwsw
凃	uwt
飡	uwv
凈	uwvl
疭	uwwg
痤	uwwj
㓆	uwx
凔	uwyb
瘡	uwyb
北	ux
疕	ux
軰	uxaf
冶	uxb
㾂	uxb
㾒	uxb
癰	uxbr
邶	uxc
㘳	uxj
丠	uxk
㽱	uxl
冀	uxnw
㼱	uxpy
背	uxq
鄁	uxqc
㿈	uxrl
兠	uxrq
瘆	uxse
凝	uxtv
癡	uxtv
䉾	uxud
痠	uxwt
疪	uxx
瘮	uxxe
㾬	uxxr
癴	uxyt
癵	uxyw
㾦	uyb
㾸	uybb
凉	uybi
凉	uybi
凛	uybj
癝	uybj
凜	uybt
癛	uybt
㾿	uyc
癠	uycr
㾕	uyf
瘴	uyfg
㾵	uyfg
疰	uyh
瘖	uyn
癔	uypu
瘯	uytt
㾗	uyv
瘁	uywf
瘀	uywu
㓍	uyxq
癕	uyxr
痎	uyxw
痃	uyxx
展	v
驅	vabb
䮙	vabk
駴	vaf
駤	vaj
戼	vakv
駥	vas
骁	vasx
駏	vav
驱	vawy
駆	vawy
䮅	vax
驒	vbbf
駰	vbg
骃	vbg
馽	vbl
䯄	vbmw
駽	vbq
韗	vbta
䪓	vbtb
郼	vbtc
韕	vbtc
䪚	vbtc
韎	vbtd
韖	vbtd
韘	vbtd
䪔	vbtd
韚	vbtf
韟	vbtf
䪙	vbtg
韔	vbth
䪒	vbth
韋	vbtj
韠	vbtj
韡	vbtj
韣	vbtl
䪘	vbtl
韛	vbtm
韝	vbtm
韞	vbtm
韥	vbtm
韢	vbtp
韒	vbtq
韜	vbtr
䪖	vbtt
䪐	vbtt
䪕	vbtu
䪗	vbtv
䪝	vbtv
韐	vbtw
䪛	vbtw
䪏	vbtw
䪑	vbtx
韍	vbty
韤	vbty
韌	vbty
䪜	vbty
䣖	vbvn
驶	vbwy
駛	vbwy
予	vc
䣕	vc
駋	vcb
驰	vcl
馳	vcl
书	vcly
龮	vcnw
豫	vcqs
䮛	vcrg
騽	vcrn
预	vcsw
預	vcsw
矛	vct
矞	vctb
務	vctc
柔	vctd
楘	vctd
㮗	vctd
鞪	vctf
䂍	vcti
堥	vctj
䂌	vctj
蟊	vctl
蝥	vctl
駳	vctl
䂈	vctl
䖥	vctl
瞀	vctm
嵍	vctm
䂎	vctm
㡔	vctm
劀	vctn
暓	vctn
矠	vctn
熃	vcto
䱯	vcto
愗	vctp
㥤	vctp
鹜	vctq
鹬	vctq
矟	vctq
鶔	vctq
鶩	vctq
鷸	vctq
䂆	vctq
䳱	vctq
䨁	vctr
奦	vcts
䂊	vcts
敄	vctt
氄	vctt
䂉	vctt
䜼	vctu
矜	vctv
骛	vctv
矡	vctv
騖	vctv
䂇	vctv
鍪	vctw
矝	vctw
䥐	vctw
婺	vctx
䋷	vctx
㜈	vctx
騛	vcuu
㐨	vcvc
騝	vcvl
馺	vcy
驦	vddm
骦	vddm
骠	vdji
驃	vdji
驔	vdnf
䮒	vdu
䮮	vdwt
騋	vdww
騕	vdxk
馸	vek
駈	vek
丑	vf
馵	vf
騹	vfbh
驖	vfbh
驩	vfbr
䭴	vfg
骐	vfh
騏	vfh
驊	vfkj
馯	vfl
騲	vfnf
䮬	vfns
䮲	vfnw
驧	vfqu
驠	vfuo
馶	vfvy
䮜	vfxd
录	vh
駬	vhd
聼	vhfp
𬩽	vhgc
彟	vhgv
寻	vhgy
䯀	vhhh
彐	vhii
隶	vhio
鹔	vhiq
肃	vhir
䏋	vhiv
鄩	vhjc
尋	vhjg
㝷	vhjg
晝	vhjk
畫	vhjk
劃	vhjn
書	vhjn
䫮	vhjs
彠	vhjv
畵	vhjx
肀	vhl
䎘	vhlc
盡	vhlm
賮	vhlm
䀆	vhlm
䀌	vhlm
㔅	vhln
歗	vhlq
鷫	vhlq
肅	vhlr
㪩	vhlv
㪖	vhlv
帇	vhml
盝	vhmn
䚄	vhmq
㞪	vhmx
䮞	vhn
剥	vhng
灵	vhow
彚	vhpd
帚	vhpm
夛	vhqy
騞	vhs
𬴃	vhs
㚑	vhsy
尹	vht
君	vhtb
郡	vhtc
帬	vhtm
焄	vhto
憨	vhtp
裠	vhtq
覠	vhtq
鵘	vhtq
頵	vhts
䪳	vhts
𫖳	vhts
群	vhtu
羣	vhtu
㪊	vhtv
敢	vhtw
饏	vhtw
䮯	vhtw
彛	vhuf
彞	vhuf
粛	vhur
骤	vhvi
驟	vhvi
䯅	vhvv
马	vi
承	vihg
乛	viii
馬	viii
㠯	viii
丞	vik
卺	vikc
烝	viko
脀	vikq
巹	vikv
㞼	vimx
騨	vinf
氶	vio
駲	vir
駫	visx
函	vixl
顄	vixs
劲	vjct
驍	vjjs
刭	vjng
驝	vjpd
䭼	vjr
颈	vjsw
䮻	vjvg
㰺	vjvq
䫗	vjvs
叚	vjvv
䮚	vjwt
䮃	vjxy
巯	vjyr
己	vk
駷	vkbi
䮠	vkbn
䮥	vkbu
邔	vkc
㠱	vkfh
馷	vkml
㞯	vkmx
骊	vkmy
驪	vkmy
䮋	vkng
驑	vknn
鵋	vkpq
忌	vkpu
䭶	vkr
䪱	vksw
駵	vktv
改	vktw
駍	vkuk
䮏	vkvb
䮊	vkvw
妀	vkxk
䮹	vlat
聿	vlii
疋	vlii
疎	vlki
蛋	vll
㿿	vlmn
䮓	vlnf
疍	vlnk
驢	vlnm
驉	vlnu
㶳	vlow
胥	vlq
衋	vlsm
叏	vlvy
疏	vlyr
駉	vmb
𬳶	vmb
驵	vmh
駔	vmh
騆	vmjb
驛	vmju
駧	vmkb
驷	vmn
駟	vmn
䮩	vmp
䮷	vmql
驨	vmrb
䮗	vmsf
駚	vmsy
颿	vmtl
騧	vmvb
䮐	vmwb
䭵	vmy
巴	vn
驲	vn
馹	vn
巼	vnbx
骒	vnd
騍	vnd
騑	vnf
𬴂	vnf
驆	vnfj
駻	vnfl
龭	vnfw
騠	vnkl
𫘨	vnkl
骋	vnkx
騁	vnkx
岊	vnmx
䮖	vnn
駎	vno
騦	vnpu
騴	vnpx
騔	vnqw
驜	vnuh
骡	vnx
騾	vnx
騉	vnxx
已	vo
䮼	voot
駣	voqg
巳	vp
䮝	vpaf
民	vpag
蟁	vpal
睯	vpam
㟩	vpam
刡	vpan
昬	vpan
暋	vpan
愍	vpap
㥸	vpap
鴖	vpaq
䪸	vpas
敃	vpat
敯	vpav
骟	vpcc
騸	vpcc
异	vpf
䮿	vpfl
导	vpgy
騌	vpji
骔	vpji
驞	vpkm
骗	vpmf
騙	vpmf
㱼	vpmv
䮟	vpov
馾	vpqg
㰝	vpqw
䮤	vprl
䮱	vpse
駜	vpt
攺	vptw
驴	vpv
馿	vpv
巽	vpvw
巺	vpvw
驼	vpx
駝	vpx
䯃	vpxk
䮨	vpyf
槩	vqad
㮣	vqad
塈	vqaj
暨	vqak
𬶨	vqak
䀈	vqam
鱀	vqao
既	vqaq
䐴	vqaq
䊠	vqau
䇒	vqay
驹	vqb
駒	vqb
即	vqc
䭹	vqc
堲	vqcj
骝	vqcn
騮	vqcn
䳭	vqcq
騘	vqep
艮	vqii
垦	vqj
駨	vqn
恳	vqpu
鵖	vqqx
䮈	vqqy
䫀	vqsw
駠	vqtc
䮪	vqtd
騊	vqtm
𫘦	vqtm
䮀	vqv
驺	vqvh
騶	vqxx
馰	vqy
驯	vr
馴	vr
騩	vrb
䮌	vrd
䮶	vrd
驸	vrgy
駙	vrgy
騜	vrh
騡	vrio
骓	vrl
騅	vrl
䮘	vrqg
骢	vrtp
驄	vrtp
騪	vrvy
骅	vrxf
駹	vse
䮆	vsfg
駓	vsk
𬳵	vsk
骑	vskb
騎	vskb
騵	vsri
𫘪	vsri
䮾	vst
䭾	vsu
䮂	vsvy
騻	vsww
駀	vsx
驮	vsy
馱	vsy
駄	vsy
尸	vt
䭷	vta
馲	vtag
屋	vtaj
剭	vtan
騀	vtat
骆	vtb
駱	vtb
劈	vtbc
孹	vtbc
檗	vtbd
㵨	vtbi
壁	vtbj
躄	vtbl
屌	vtbm
幦	vtbm
憵	vtbp
鼊	vtbp
臂	vtbq
襞	vtbq
鷿	vtbq
鸊	vtbq
䴙	vtbq
礕	vtbs
擘	vtbt
糪	vtbu
鐾	vtbw
䢃	vtbw
嬖	vtbx
繴	vtbx
辟	vtby
譬	vtby
璧	vtby
甓	vtby
局	vtcb
屙	vtcb
孱	vtcc
㞌	vtck
駞	vtcl
杘	vtd
屚	vtdo
屩	vteb
屧	vted
屣	vtel
㞞	vtel
㞛	vten
履	vtet
屐	vtev
屦	vtex
屜	vtex
屨	vtex
㞜	vtex
居	vtfb
屟	vtfd
壂	vtfj
䮔	vtfk
殿	vtfm
剧	vtfn
臀	vtfq
展	vtfq
鶋	vtfq
䮢	vtfr
臋	vtfw
屉	vtfx
㞗	vtgy
斸	vtie
屬	vtil
劚	vtin
㓾	vtin
尿	vtio
屑	vtiq
犀	vtit
駯	vtiw
䣝	vtjc
尉	vtjg
㷉	vtjg
螱	vtjl
屠	vtjn
熨	vtjo
慰	vtjp
褽	vtjq
鷵	vtjq
㞡	vtjq
犚	vtjt
叞	vtjv
层	vtjx
屆	vtjx
騈	vtkf
㞖	vtki
屍	vtkx
䭽	vtl
眉	vtm
郿	vtmc
凥	vtmg
屈	vtmm
屭	vtmm
刷	vtmn
鹛	vtmq
鶌	vtmq
鶥	vtmq
㕞	vtmv
屃	vtmw
屓	vtmw
屇	vtnb
屝	vtnf
届	vtno
䮡	vtnt
㞑	vtox
屪	vtpi
屄	vtpw
䮉	vtq
駪	vtqg
𬳽	vtqg
㞔	vtqq
尻	vtqt
鳲	vtqx
鸤	vtqx
䲩	vtqx
㞍	vtqy
㞒	vtrm
驕	vtsb
㞘	vtse
㞠	vtsi
屒	vtsj
骄	vtsr
尾	vtta
屘	vttc
屛	vttf
屗	vttg
㞙	vtti
㔉	vttn
㞏	vttp
㞚	vttr
属	vtty
屎	vtud
屏	vtuf
層	vtun
㞟	vtus
羼	vtuu
屡	vtux
屢	vtux
騬	vtux
㞎	vtvn
㞋	vtvy
駇	vtw
䭿	vtwg
㞕	vtwq
䬤	vtwv
尼	vtx
屫	vtxb
㞓	vtxn
䲿	vtxq
屁	vtxx
尺	vty
屖	vtyf
昼	vtyk
尽	vtyu
㞐	vtyu
咫	vtyw
骈	vuf
駢	vuf
驓	vumn
骥	vunw
驥	vunw
駾	vuq
騚	vuqn
驎	vuqt
𬴊	vuqt
买	vusy
驣	vuv
䮫	vuxk
皮	vv
騳	vv
駶	vvcb
骣	vvcc
驏	vvcc
皯	vvfl
騄	vvh
𫘧	vvh
骕	vvir
驿	vvjl
騢	vvjv
騤	vvks
骙	vvks
䮴	vvku
騒	vvl
䮇	vvl
驌	vvlr
㓟	vvng
㿸	vvnv
皹	vvpa
㿹	vvpu
駸	vvpv
骎	vvpv
龾	vvqu
皰	vvqv
㿪	vvqy
㿵	vvss
颇	vvsw
頗	vvsw
驈	vvtb
騥	vvtd
駊	vvv
驫	vvv
骉	vvv
䮣	vvvd
䯂	vvvd
驋	vvvm
㿬	vvvn
䮕	vvvv
駃	vvwg
𫘝	vvwg
㿳	vvxn
驭	vvy
馭	vvy
駅	vvy
骚	vvyl
騷	vvyl
験	vwbw
驗	vwbw
䭻	vwco
駗	vwe
夬	vwg
䮑	vwgy
駩	vwh
验	vwik
䮭	vwmq
䮳	vwn
刔	vwng
駖	vwp
騟	vwqn
鴂	vwqx
䮎	vwsm
駼	vwt
𬳿	vwt
騇	vwtm
驳	vwwy
駁	vwwy
䭸	vwwy
騱	vwxs
𫘬	vwxs
騣	vwxt
騐	vwyp
弓	vx
弫	vxa
弬	vxa
彄	vxab
㣅	vxan
弡	vxav
𫸩	vxaw
骀	vxb
駘	vxb
勥	vxbc
彈	vxbf
强	vxbl
弲	vxbq
犟	vxbt
䥒	vxbw
謽	vxby
㢴	vxby
弨	vxcb
弛	vxcl
㢾	vxdj
弧	vxex
䮁	vxf
弽	vxfd
㢨	vxfl
㣁	vxfm
彉	vxfw
㣀	vxfw
张	vxha
張	vxha
弭	vxhd
㢽	vxhv
㣄	vxid
弾	vxif
弰	vxiq
疆	vxjk
䰞	vxju
㢪	vxjx
弖	vxk
㢧	vxk
彁	vxkb
弙	vxkg
㣆	vxkh
弳	vxkj
彊	vxkk
㣂	vxku
弻	vxkv
䰜	vxkv
彌	vxkw
䥸	vxkw
㜷	vxkx
瓕	vxky
引	vxl
弔	vxl
盄	vxlm
㢭	vxlv
彋	vxmq
㢷	vxmq
彏	vxmv
㢫	vxmx
彃	vxnj
舝	vxpt
馻	vxqg
弥	vxqi
弸	vxqq
弞	vxqw
弤	vxqy
㢩	vxqy
弗	vxr
鄪	vxrc
㔗	vxrc
弣	vxrg
费	vxrm
費	vxrm
刜	vxrn
㪄	vxrt
㢿	vxrt
艴	vxrv
骖	vxse
㢶	vxsn
弼	vxsv
㢬	vxsx
㢮	vxtc
㢳	vxtq
矤	vxts
騃	vxts
㢻	vxtx
彅	vxuc
弹	vxuf
㢼	vxui
鶸	vxuq
弱	vxuu
鬻	vxuu
粥	vxuv
㢯	vxva
弪	vxvj
弝	vxvn
彇	vxvr
㢸	vxvt
㢰	vxvv
㢲	vxvw
弜	vxvx
㢵	vxwb
骏	vxwt
駿	vxwt
驂	vxxe
㢱	vxxi
強	vxxl
弢	vxxv
弘	vxxy
弴	vxyc
㢹	vxyf
弶	vxyi
㣃	vxyv
彍	vxyw
弦	vxyx
婱	vxyx
㢺	vxyx
又	vy
戏	vyat
䮦	vybb
驙	vybk
骧	vybq
驤	vybq
驐	vybt
圅	vybu
䯁	vyby
邓	vyc
䮺	vycr
劝	vyct
騂	vyf
骍	vyf
騿	vyfg
癷	vyfl
馼	vyg
𫘜	vyg
怼	vygp
对	vygy
驻	vyh
駐	vyh
癶	vyii
龴	vyii
圣	vyj
発	vyjq
頚	vyjs
戣	vyka
鄈	vykc
鄧	vykc
凳	vykm
㔁	vykn
覴	vykq
䳫	vykq
䳾	vykq
癸	vyks
㲪	vykt
登	vyku
㽅	vyky
㦷	vyma
勇	vymc
勈	vymc
䮰	vymf
䭺	vymg
甬	vymj
恿	vymp
观	vymq
覌	vymq
癹	vymv
㪌	vymv
㼧	vymy
䮵	vynj
䮽	vyow
騯	vypy
䮍	vyq
欢	vyqw
鸡	vyqx
鳮	vyqx
难	vyrl
駺	vyv
桑	vyvd
叠	vyvm
發	vyvm
剟	vyvn
㔇	vyvn
艰	vyvq
欼	vyvq
歠	vyvq
鵽	vyvq
颡	vyvs
顙	vyvs
䫎	vyvs
毲	vyvt
敪	vyvt
叒	vyvv
叕	vyvv
敠	vyvv
㯩	vyvw
双	vyvy
㕛	vyvy
駮	vyww
騼	vyx
骇	vyxw
駭	vyxw
䮄	vyxx
𫠊	vyxx
叉	vyy
蚤	vyyl
八	w
錢	waat
钷	wab
鉕	wab
鏂	wabb
鑎	wabm
䥲	wabq
铖	wac
铘	wac
鋣	wac
鋮	wac
鏩	waek
銍	waj
铚	waj
鉽	wajl
銊	wak
鍼	wakb
釾	wal
䥺	wal
鏚	wali
鉔	waml
䤷	wanx
铽	wapu
鋱	wapu
鐕	waqn
铙	wasx
钱	wat
鈛	wat
銭	wat
龯	wat
鑑	watm
鑬	watq
钜	wav
鉅	wav
鏗	wavj
鑦	wavm
钺	wax
鉞	wax
錷	wax
釴	way
𬬩	way
合	wb
釦	wb
㕣	wb
铝	wbb
鋁	wbb
䤧	wbb
鐰	wbbd
鋛	wbbl
锷	wbbx
鍔	wbbx
郃	wbc
翕	wbcc
翖	wbcc
歙	wbcq
䤢	wbct
㪧	wbcv
㽂	wbcy
樖	wbdb
盫	wbdm
弇	wbf
锢	wbfb
錮	wbfb
铟	wbg
銦	wbg
锃	wbh
鋥	wbh
鍓	wbhd
鿖	wbk
鋘	wbks
钟	wbl
鈡	wbl
鋜	wbll
鐀	wblm
鏴	wblt
敆	wblv
铞	wbml
銱	wbml
盒	wbmn
锅	wbmw
畣	wbnb
㓣	wbng
鋗	wbq
𫓶	wbq
兌	wbqg
敓	wbqt
欱	wbqw
鸽	wbqx
鴿	wbqx
䧻	wbrl
龛	wbst
龕	wbst
颌	wbsw
頜	wbsw
拿	wbtg
㧱	wbtg
搻	wbtt
㪉	wbtw
㿯	wbvv
鉙	wbw
㑒	wbwg
㰸	wbwq
㪘	wbwt
鉂	wbwy
钌	wc
釕	wc
鉊	wcb
鉫	wcb
鉰	wcb
𬬿	wcb
兺	wcbx
郛	wcc
邠	wcc
䦀	wcc
㔜	wcct
钖	wce
弅	wcf
钇	wcg
釔	wcg
㐍	wcg
坌	wcj
孚	wck
釨	wck
锕	wckb
錒	wckb
瓫	wcky
蚠	wcl
釶	wcl
盆	wcmn
锰	wcmn
錳	wcmn
贫	wcmw
貧	wcmw
岔	wcmx
鐊	wcne
分	wco
刅	wco
釖	wco
炃	wcow
釢	wcp
忿	wcpu
鳻	wcqx
䳕	wcqx
鑃	wcrl
颁	wcsw
頒	wcsw
办	wct
釛	wct
㲗	wcta
嗠	wctb
铤	wctj
鋌	wctj
鋋	wctl
攽	wctw
䥙	wcus
键	wcvl
鍵	wcvl
鏐	wcwe
镠	wcwe
㟗	wcwm
乳	wcx
㐠	wcxc
釰	wcy
釼	wcy
鈒	wcy
钑	wcy
麄	wcyx
采	wd
鈢	wd
䥮	wdac
䣋	wdc
彩	wde
鎛	wdgy
鏄	wdgy
镈	wdgy
䎹	wdhd
釆	wdii
𬭊	wdj
镖	wdji
鏢	wdji
钵	wdk
鉢	wdk
釋	wdmu
镭	wdnb
鐳	wdnb
镡	wdnf
鐔	wdnf
釉	wdno
錰	wdow
悉	wdpu
鏸	wdpu
䦄	wdq
䥤	wdqv
䧽	wdrl
鑐	wdsm
铺	wdu
鋪	wdu
䥔	wdud
释	wdvj
釈	wdvy
鑻	wdwt
䥑	wdwt
錸	wdww
鉥	wdy
𬬸	wdy
钐	we
釤	we
貙	weab
䝙	weaw
貚	webf
貂	wecb
䝗	wed
䝖	weei
鑕	weem
貈	weeu
豻	wefl
鍎	wefm
锧	wefm
貓	wefn
貛	wefr
貘	wefs
䝡	wefy
豺	wegt
䝟	wehs
釽	wei
䝣	weid
豸	weii
釿	wek
𬬱	wek
銗	wekb
䥿	wekc
貆	wekk
鋲	wekw
䝞	welm
貀	wemm
貒	wems
䥩	wemt
貜	wemv
䝘	wemv
豽	wemw
貋	wenf
貍	wenj
蠫	wenl
㦟	wenp
䝢	wenv
貁	wepw
䤨	weq
豿	weqb
锨	weqw
鍁	weqw
豹	weqy
貅	werd
貏	werf
䝥	werf
貃	wern
㦝	werp
貌	werq
貎	werq
貔	werx
䝝	wesb
䝤	wesi
䝠	wesi
豾	wesk
貊	wesn
䫉	wesw
貉	wetb
䥏	wetc
䝦	weti
貖	weum
貗	weux
墾	wevj
貄	wevl
懇	wevp
貇	wevq
貑	wevv
䝛	wevv
䝚	wevx
钣	wevy
鈑	wevy
鏦	wewl
貐	wewn
貕	wews
鈲	wex
䝜	wext
豼	wexx
鑶	wfaa
䥠	wfab
钴	wfb
鈷	wfb
鐵	wfbh
鑵	wfbr
鐡	wfbu
鍣	wfcb
䥬	wfdg
鐁	wfek
鐷	wffd
鐼	wffm
针	wfg
針	wfg
錤	wfh
𫓹	wfh
鑮	wfig
钳	wfj
鉗	wfj
䥓	wfj
鑉	wfjm
鐯	wfjn
䦃	wfjn
鏵	wfkj
釬	wfl
鍈	wfms
锳	wfms
镇	wfmw
鎮	wfmw
鏋	wfmy
鑖	wfmy
错	wfn
錯	wfn
锚	wfnb
錨	wfnb
镆	wfns
鏌	wfns
鐄	wfnw
𨱑	wfnw
铹	wfpc
鋍	wfpc
鑝	wfph
鎍	wfpx
鍸	wfq
鋴	wfqg
鏾	wfqt
䥫	wfrl
镬	wfrv
鑊	wfrv
錵	wfrx
锘	wfsb
鍩	wfsb
䥈	wfsf
钄	wfui
鈘	wfvy
鉷	wfw
𫟹	wfw
鎝	wfwb
𨱏	wfwb
銰	wfwy
鉪	wfx
鍖	wfx
鍱	wfxd
鋩	wfya
铓	wfya
錺	wfyc
人	wg
仺	wgak
㒪	wgas
仓	wgc
戗	wgca
创	wgcn
鸧	wgcq
㐱	wge
仐	wgfg
全	wgh
氽	wgio
尒	wgiw
舎	wgjb
郐	wgjc
舗	wgjd
佘	wgji
仝	wgjl
刽	wgjn
畲	wgjn
会	wgjx
个	wgl
企	wgll
虢	wglm
仚	wgmx
䥟	wgnw
銶	wgoy
𨱇	wgoy
介	wgr
鿗	wgrk
䲸	wgrq
㰡	wgrq
㖋	wgrx
頱	wgsw
釮	wgt
㲕	wgta
舖	wgtd
舍	wgtm
鵨	wgtq
䧾	wgtr
舒	wgtv
舘	wgtv
仒	wgu
伞	wguk
㦰	wgwa
傘	wgwf
从	wgwg
仌	wgwg
耸	wgwh
坐	wgwj
丛	wgwk
韱	wgwk
俎	wgwm
睂	wgwm
䁞	wgwm
剉	wgwn
㫺	wgwn
怂	wgwp
夎	wgwt
众	wgww
仑	wgx
亽	wgy
寽	wgy
戧	wgya
含	wgyb
倉	wgyb
䎏	wgyc
酓	wgyd
贪	wgym
盦	wgym
貪	wgym
創	wgyn
㓧	wgyn
念	wgyp
衾	wgyq
欦	wgyq
飮	wgyq
鳹	wgyq
鶬	wgyq
䳺	wgyq
㱃	wgyq
雂	wgyr
䨄	wgyr
颔	wgys
頷	wgys
敜	wgyt
今	wgyv
㪁	wgyv
禽	wgyx
侌	wgyx
韽	wgyy
㼨	wgyy
鋹	wha
𬬮	wha
鑩	whbb
鎁	whc
䦁	whc
䥹	whcl
锲	whcs
鍥	whcs
䤿	whct
䥛	whcx
铒	whd
鉺	whd
铸	whgy
鋳	whgy
錱	whh
鑷	whhh
鏏	whhv
𬭬	whhv
銇	whi
䥊	whmw
锖	whq
錆	whq
錶	whq
鿏	whtw
镊	whvv
鋷	whvy
銸	whx
钰	why
鈺	why
金	wi
铴	wice
鏿	wid
鎃	wieq
钅	wiii
爫	wiii
釒	wiii
䤬	wiit
镗	wij
鏜	wij
鍅	wijx
鋿	wimb
鏛	wiml
钂	wimo
锁	wimw
鎖	wimw
鑜	wimw
錔	win
鐺	winb
鐋	wine
淾	wio
鎲	wip
镋	wip
销	wiq
銷	wiq
銂	wir
銧	wisx
钞	wit
鈔	wit
鐣	witg
铛	wivh
𬭛	wivv
釥	wiw
钍	wj
釷	wj
銡	wjb
𬭳	wjbb
鎱	wjbq
﨧	wjck
銢	wjio
銾	wjio
銈	wjj
𫓯	wjj
䥗	wjjq
鐃	wjjs
铐	wjkx
銬	wjkx
釭	wjl
鑟	wjmm
锗	wjn
鍺	wjn
鋕	wjpu
鈨	wjqg
﨨	wjuj
鑄	wjvg
㥯	wjvp
鈇	wjwg
𫓧	wjwg
錴	wjwj
鑚	wjwm
鐟	wjwn
鶏	wjwq
䤲	wjwr
錂	wjwt
铑	wjx
釫	wjx
銠	wjx
鎑	wjxm
鉣	wjxy
錻	wkal
钶	wkb
鈳	wkb
鎶	wkbb
鿔	wkbb
命	wkbc
劎	wkbc
龠	wkbf
鋉	wkbi
䶵	wkbm
䶳	wkbm
剣	wkbn
劍	wkbn
鍢	wkbn
㥐	wkbp
歛	wkbq
鏉	wkbq
鸙	wkbq
龡	wkbq
龤	wkbr
顩	wkbs
龥	wkbs
斂	wkbt
龢	wkbt
镉	wkbu
鋀	wkbu
鎘	wkbu
龣	wkbv
僉	wkbw
剱	wkby
劒	wkby
劔	wkby
鈃	wkf
钘	wkf
䤯	wkfe
鉶	wkfn
铏	wkfn
釪	wkg
亼	wkii
佥	wkik
剑	wkin
敛	wkit
佱	wkkl
钉	wkl
釘	wkl
钲	wkll
鉦	wkll
钙	wklx
鈣	wklx
鄶	wkmc
侖	wkmf
朇	wkmf
鍊	wkmi
劊	wkmn
會	wkmn
鏪	wkmn
鈵	wkmw
錬	wkni
鐂	wknn
㑹	wknn
鐚	wknp
錏	wknu
铔	wknu
錽	wkot
鋄	wkov
鄃	wkqc
俞	wkqn
㓱	wkqn
愈	wkqp
觎	wkqq
歈	wkqq
覦	wkqq
毹	wkqt
㼶	wkqy
銒	wksf
鶢	wksq
爰	wksv
䥻	wksx
铼	wkud
铗	wkus
鋙	wkvb
铻	wkvb
侴	wkvn
銕	wkvw
鑈	wkww
兮	wkx
鋞	wkxj
㿽	wkxm
䒊	wkxv
钝	wkxx
鈍	wkxx
鉵	wl
鐬	wlat
钻	wlb
鉆	wlb
鏀	wlbo
钋	wlg
釙	wlg
䤮	wlit
鉲	wlkl
钀	wlks
䤠	wll
錿	wlmg
鍞	wlmw
鐪	wlnc
鋽	wlnf
鑪	wlnm
鑢	wlnp
䥧	wlpm
錹	wlq
鐻	wlse
鎼	wltg
鏬	wltu
𬬻	wlvt
鈙	wlvy
鑡	wlw
钢	wm
钼	wm
鉬	wm
铅	wmb
鉛	wmb
㐥	wmcc
锄	wmct
鋤	wmct
䤪	wmd
䤱	wmek
錪	wmfw
釠	wmg
鉏	wmh
䤽	wmio
爯	wmj
䤡	wmj
錭	wmjb
鐸	wmju
铜	wmkb
銅	wmkb
鎠	wmkl
鐶	wmkq
镮	wmkq
鎧	wmku
鈯	wmm
銏	wmmk
銟	wmml
鑺	wmmr
钁	wmmv
䦆	wmmv
铡	wmng
鍘	wmng
𬭶	wmo
觅	wmqg
覓	wmqg
鋧	wmqg
镯	wmql
鐲	wmql
鏰	wmqq
镚	wmqq
锣	wmqy
鑴	wmrb
䥴	wmrc
鏙	wmrl
錌	wmsf
鍴	wmsm
鉠	wmsy
鎽	wmth
鋼	wmum
龬	wmuy
鈠	wmv
鍋	wmvb
爵	wmvg
铠	wmvk
钡	wmw
鋇	wmw
钠	wmwg
鈉	wmwg
䤫	wmwv
鑼	wmxr
鐤	wmxv
䥯	wmxx
钒	wmy
釩	wmy
番	wn
鈤	wn
㸓	wn
钿	wnb
鈿	wnb
鄱	wnc
翻	wncc
鎉	wncc
勫	wnct
飜	wncu
锞	wnd
錁	wnd
䤵	wnf
鑤	wnfi
鏎	wnfj
銲	wnfl
钊	wng
釗	wng
鎤	wnis
锂	wnj
鋰	wnj
䥵	wnjs
钽	wnk
鉭	wnk
鍚	wnke
锝	wnkg
鍀	wnkg
鍉	wnkl
鍡	wnkq
㽃	wnky
鉮	wnl
𬬹	wnl
鎾	wnmn
镘	wnmv
鏝	wnmv
鍝	wnmy
錩	wnn
锠	wnn
鑸	wnnj
鑘	wnnn
铀	wno
鈾	wno
钾	wnp
鉀	wnp
锶	wnpu
鍶	wnpu
锡	wnqe
錫	wnqe
鍻	wnqw
鷭	wnqx
𬸪	wnqx
鍟	wnth
鑆	wnug
镤	wnuh
鏷	wnuh
铿	wnvj
鎅	wnwr
镙	wnx
鏍	wnx
䥪	wnxo
锟	wnxx
錕	wnxx
鐛	wnyi
鐒	wooc
鑅	wood
锬	woow
錟	woow
铫	woqg
銚	woqg
钬	wow
鈥	wow
令	wp
链	wpaf
鍕	wpaf
鏈	wpaf
镩	wpbl
鑓	wpbv
邻	wpc
翎	wpcc
䥇	wpcc
䦂	wpcc
镔	wpew
鑳	wpfl
鑧	wpfy
锭	wpg
錠	wpg
鎋	wphb
錝	wpji
鋎	wpjq
䥂	wpjs
鐽	wpju
鍹	wpkk
鑌	wpkm
鏔	wpkw
䥾	wpkx
瓴	wpky
鐹	wpmb
鍽	wpmf
䤟	wpmg
鎺	wpmh
刢	wpng
䤹	wpov
鑏	wppk
愛	wppt
鋺	wpqc
鈂	wpqg
䑟	wpqh
镲	wpqj
鑔	wpqj
䴄	wpqq
舜	wpqt
鴒	wpqx
鸰	wpqx
䥉	wpqy
䥃	wprl
鏥	wprn
䥱	wpro
鑹	wprx
镓	wpse
鎵	wpse
䥦	wpsq
錑	wpsu
爱	wpsv
领	wpsw
領	wpsw
鋐	wpsx
𬭎	wpsx
𫟼	wpsy
铋	wpt
鉍	wpt
䤩	wpta
鏠	wpth
鎚	wptv
鈊	wpu
鎹	wpus
鐩	wpus
𬭼	wpus
鈩	wpv
錧	wpv
受	wpvy
辤	wpvy
鎔	wpwb
镕	wpwb
铊	wpx
鉈	wpx
铵	wpxk
銨	wpxk
钥	wq
鈅	wq
䏌	wq
銽	wqab
錉	wqan
铭	wqb
鉤	wqb
銘	wqb
鋔	wqbq
鐌	wqbs
鑱	wqby
镵	wqby
䤝	wqc
镏	wqcn
鎦	wqcn
䥼	wqe
锪	wqep
鍃	wqep
鍯	wqep
尣	wqg
尩	wqh
鉨	wqi
鿭	wqi
铄	wqiw
镥	wqkn
銁	wqn
钨	wqo
鎢	wqo
鑥	wqon
錋	wqq
尦	wqqy
鉹	wqqy
錎	wqrj
䤥	wqsc
䝇	wqse
釚	wqt
铆	wqtc
鉚	wqtc
鋾	wqtm
钧	wqu
鈞	wqu
憌	wqup
鉋	wqv
铇	wqv
铮	wqvl
錚	wqvl
铯	wqvn
銫	wqvn
钦	wqw
欽	wqw
鵭	wqx
钩	wqxy
鈎	wqxy
钓	wqy
釣	wqy
釸	wqy
釻	wqy
鍧	wqy
钏	wr
釧	wr
䤦	wrat
銄	wrb
镌	wrcp
鎸	wrcp
镍	wrd
銝	wrd
鎳	wrd
鏶	wrd
䥡	wrfd
錍	wrfg
鎨	wrfg
鉜	wrgy
銵	wrh
鍠	wrh
锽	wrh
锻	wrhm
鍛	wrhm
䤼	wrio
舀	wrj
锥	wrl
錐	wrl
鐫	wrlc
鎀	wrle
鏅	wrlq
锦	wrml
錦	wrml
铂	wrn
鉑	wrn
㒶	wrn
鐎	wrow
鎴	wrpu
銋	wrtj
鏓	wrtp
鐭	wrus
鍭	wrvt
𬭤	wrvt
锼	wrvy
鎪	wrvy
鎫	wrwt
鎞	wrwx
鈋	wrx
铧	wrxf
䥞	wryt
鉐	ws
鈪	wsc
䤺	wsek
锛	wsff
錛	wsff
銔	wsfg
䥄	wsfn
鎒	wsgy
鋠	wsj
錼	wsji
鍷	wsjj
䤻	wsjq
銙	wsjx
鉟	wsk
錡	wskb
锜	wskb
钚	wsl
鈈	wsl
銌	wslc
钸	wsml
鈽	wsml
䥳	wsmt
銆	wsn
䤶	wsnx
铕	wsq
銪	wsq
䥎	wsq
鑨	wst
䥶	wstl
镣	wsui
鐐	wsui
镢	wsuq
鐝	wsuq
钹	wsvy
鈸	wsvy
顉	wsw
鋏	wsww
鏯	wsww
䤞	wsx
鈜	wsxy
钛	wsy
釱	wsy
鈦	wsy
余	wt
䤜	wtag
锇	wtat
鋨	wtat
铬	wtb
鉻	wtb
䣄	wtc
釳	wtcg
鉇	wtcl
锈	wtcp
銹	wtcp
鉌	wtd
钎	wtfg
釺	wtfg
锤	wtfk
錘	wtfk
锸	wtfr
鍤	wtfr
鉎	wth
锋	wthl
鋒	wthl
铢	wtiw
銖	wtiw
锆	wtj
鋯	wtj
鈓	wtj
㸒	wtj
铥	wtjx
銩	wtjx
鏼	wtki
锺	wtkj
鍾	wtkj
鑂	wtko
鈝	wtl
鈼	wtlg
敍	wtlv
銛	wtm
铦	wtm
䍃	wtm
鋵	wtmg
鉓	wtml
颻	wtml
嵞	wtmm
䥷	wtmn
飖	wtmw
峹	wtmx
畬	wtnb
鏫	wtnd
鋓	wtng
鍑	wtnt
锹	wtow
鍬	wtow
悆	wtpu
懖	wtpu
铣	wtqg
銑	wtqg
鑽	wtqm
鑗	wtqw
鹞	wtqx
鷂	wtqx
䳜	wtqx
雓	wtrl
鉃	wts
鐈	wtsb
鑙	wtsn
敘	wttw
繇	wttx
鉖	wtu
厁	wtuc
鎎	wtud
斜	wtuf
㙦	wtuj
䤣	wtuk
噕	wtvb
爳	wtvc
鄬	wtvc
爲	wtvo
叙	wtvy
铁	wtwg
鉄	wtwg
錗	wtxk
鋂	wtxu
釞	wty
䥨	wubb
锩	wuc
錈	wuc
銤	wud
䥜	wud
鐏	wudg
𨱔	wudg
䥖	wuds
鉼	wuf
钭	wufg
鈄	wufg
鉡	wuj
鎈	wujl
锎	wukf
鐦	wukf
镧	wuki
鑭	wuki
鏳	wumn
䥕	wumt
𬭯	wumt
锏	wun
鐧	wun
镨	wunn
鐠	wunn
钔	wup
鍆	wup
锐	wuq
鋭	wuq
鐗	wuq
锵	wuqg
鎆	wuqn
鏻	wuqt
𬭸	wuqt
镁	wusy
鎂	wusy
鐥	wuub
䦅	wuub
锑	wuvt
銻	wuvt
鎌	wuw
镒	wuwm
鎰	wuwm
鉳	wux
錓	wux
镂	wuxk
鏤	wuxk
鎙	wuxq
鎡	wuxx
镃	wuxx
食	wv
鈻	wv
鎷	wv
餞	wvaa
饇	wvab
鈱	wvag
䬹	wvaj
鍲	wvan
䭙	wvan
饶	wvas
饯	wvat
䬻	wvat
䭅	wvbf
镪	wvbl
鏹	wvbl
馈	wvbm
饋	wvbm
䬼	wvbq
鍏	wvbt
䥁	wvbu
䭂	wvbv
鐴	wvby
饲	wvcb
锔	wvcb
鋦	wvcb
飼	wvcb
䬰	wvcb
饧	wvce
䬢	wvco
䭈	wvcv
餺	wvdg
馎	wvdg
馇	wvdk
餷	wvdk
䬱	wvdk
餔	wvdu
餰	wvei
饭	wvev
飯	wvev
钮	wvf
鈕	wvf
锯	wvfb
鋸	wvfb
饽	wvfc
餑	wvfc
䭎	wvfd
䭟	wvfd
䭦	wvfg
馑	wvfh
饉	wvfh
飦	wvfl
饙	wvfm
饚	wvfm
餬	wvfq
馍	wvfs
饃	wvfs
饛	wvfs
䭊	wvfs
馓	wvft
饊	wvft
餀	wvfw
餝	wvfy
録	wvh
餦	wvha
饵	wvhd
餌	wvhd
䭍	wvhm
饓	wvid
饣	wvii
飠	wvii
饄	wvij
钃	wvil
䤴	wvix
饎	wvjb
鐞	wvjg
铎	wvjl
饁	wvjm
馌	wvjm
䬧	wvjq
饒	wvjs
饐	wvju
鍜	wvjv
䬴	wvkd
餗	wvki
𫗧	wvki
飣	wvkl
饤	wvkl
䭄	wvkl
馕	wvkq
饢	wvkq
鍨	wvks
镫	wvku
鐙	wvku
餖	wvku
饾	wvku
饨	wvkx
飩	wvkx
蚀	wvl
爭	wvl
蝕	wvl
鈏	wvl
鈟	wvl
銉	wvl
䬯	wvlb
鏽	wvlr
饖	wvlt
镅	wvm
鎇	wvm
餇	wvmb
䭨	wvmb
饥	wvmg
飢	wvmg
飷	wvmh
銿	wvmj
飿	wvmm
饳	wvmm
餶	wvmp
馉	wvmp
覶	wvmq
饠	wvmr
䬬	wvms
䭓	wvmu
䭞	wvmu
䬦	wvmv
亂	wvmx
辭	wvmy
钯	wvn
鈀	wvn
餜	wvnd
馃	wvnd
餳	wvne
䭘	wvni
饆	wvnj
䭪	wvnj
饂	wvnm
餵	wvnq
馒	wvnv
饅	wvnv
餲	wvnw
馄	wvnx
餛	wvnx
餤	wvoo
餆	wvoq
釲	wvp
餫	wvpa
䭏	wvpf
䭀	wvpf
䭢	wvpk
餸	wvps
飶	wvpt
馆	wvpv
锓	wvpv
鋟	wvpv
館	wvpv
䭔	wvpv
䭤	wvpv
银	wvq
銀	wvq
䭇	wvqb
䬲	wvqb
飹	wvqc
䶿	wvqg
馏	wvqn
餾	wvqn
䬷	wvqq
䬨	wvqq
馅	wvqr
餡	wvqr
馋	wvqu
饱	wvqv
飽	wvqv
饮	wvqw
飲	wvqw
飮	wvqw
饞	wvqy
䬫	wvqy
鉘	wvr
饷	wvrb
餉	wvrb
餽	wvrb
䭋	wvrd
餭	wvrh
镄	wvrm
鐨	wvrm
䭒	wvrp
餁	wvrt
餱	wvrt
馊	wvrv
餿	wvrv
餴	wvsf
䭜	wvsi
䬪	wvsl
䭉	wvsq
餪	wvss
餣	wvsx
饿	wvta
飥	wvta
餓	wvta
饦	wvta
鐍	wvtb
餎	wvtb
饹	wvtb
𫔎	wvtb
饬	wvtc
饩	wvtc
飭	wvtc
䬣	wvtc
鍒	wvtd
餠	wvtf
饪	wvtj
飪	wvtj
飵	wvtl
饰	wvtm
飾	wvtm
餂	wvtm
饡	wvtm
饫	wvts
飫	wvts
餼	wvtu
餧	wvtx
饍	wvub
饼	wvuf
餅	wvuf
䬺	wvuh
䬳	wvuj
餻	wvuo
䭐	wvup
䬽	wvuq
䬾	wvut
馐	wvuv
饈	wvuv
䭑	wvuw
䭥	wvuy
铍	wvv
鈹	wvv
鎟	wvvd
鏺	wvvm
䬶	wvvq
䭛	wvvt
䬿	wvvt
錣	wvvv
餟	wvvv
馔	wvvw
鐉	wvvw
饌	wvvw
餄	wvwb
饸	wvwb
飻	wvwe
鈌	wvwg
飤	wvwg
餙	wvwm
䭝	wvwn
䭡	wvwp
䭃	wvwp
餚	wvwq
饀	wvwr
馀	wvwt
餘	wvwt
餩	wvww
馁	wvwx
餒	wvwx
铌	wvx
鈮	wvx
饴	wvxb
飴	wvxb
餯	wvxs
餕	wvxt
馂	wvxt
饑	wvxw
䬮	wvxw
钗	wvy
釵	wvy
鈬	wvy
餢	wvyb
餹	wvyb
飳	wvyh
䭚	wvyj
饘	wvyk
𫗴	wvyk
飰	wvyl
䭩	wvyn
䭖	wvyo
餏	wvyq
饟	wvyq
饻	wvyq
䭗	wvyq
䭣	wvyr
饝	wvys
䭠	wvyu
饺	wvyw
餃	wvyw
䬵	wvyw
䭧	wvyx
釟	ww
釡	ww
鍂	ww
谷	wwb
铪	wwb
鉿	wwb
谺	wwba
谽	wwbb
卻	wwbc
郤	wwbc
豂	wwbe
鑰	wwbf
䜰	wwbf
谻	wwbj
谾	wwbj
䜫	wwbj
螸	wwbl
豄	wwbm
䜬	wwbn
慾	wwbp
欲	wwbq
鹆	wwbq
銳	wwbq
鵒	wwbq
䜪	wwbq
豀	wwbs
豅	wwbs
㞃	wwbs
豃	wwbt
䜮	wwbt
䜯	wwbu
䜱	wwbv
谼	wwbw
鐱	wwbw
谹	wwbx
䜲	wwbx
爷	wwc
鋢	wwck
鈖	wwco
铩	wwd
鎩	wwdm
鉁	wwe
斧	wwek
釜	wwfu
锊	wwgy
鋝	wwgy
铨	wwh
銓	wwh
爺	wwhc
鉩	wwiw
㸙	wwjn
锾	wwkv
鍰	wwkv
㸗	wwmb
錀	wwmf
㸖	wwmh
㸘	wwmk
鐇	wwn
𫔍	wwn
鑁	wwot
铃	wwp
鈴	wwp
鑀	wwpt
鏭	wwpu
鍮	wwqn
爹	wwqq
䤾	wwrj
䤭	wwsm
镎	wwtg
鎿	wwtg
鎐	wwtm
爸	wwvn
鑫	www
鋊	wwwb
锉	wwwj
銼	wwwj
鑯	wwwk
䥘	wwwn
𬬭	wwx
鎓	wwxc
𬭩	wwxc
鋖	wwxk
鍐	wwxt
鈆	wwxy
父	wwy
鋡	wwyb
鎗	wwyb
錜	wwyp
钤	wwyv
鈐	wwyv
钆	wx
釓	wx
銯	wx
铷	wxb
鈶	wxb
銣	wxb
鑞	wxbx
镴	wxbx
翁	wxcc
勜	wxcc
鶲	wxcq
鹟	wxcq
枀	wxd
㼏	wxex
鐑	wxjb
妥	wxk
钕	wxk
釹	wxk
錄	wxki
䥀	wxkl
鍿	wxkn
瓮	wxky
䤛	wxl
鎻	wxmw
鏆	wxmw
锱	wxnb
錙	wxnb
鏁	wxnd
忩	wxpu
兊	wxqg
鈗	wxqg
毤	wxqt
鵎	wxqx
䲲	wxqx
䤸	wxse
鏘	wxsg
颂	wxsw
頌	wxsw
鉾	wxtl
䥽	wxty
鉧	wxu
𬭁	wxu
鋑	wxwt
乿	wxx
鈚	wxx
谿	wxxb
鑠	wxxd
鏒	wxxe
鷄	wxxq
㰿	wxxq
锴	wxxr
鍇	wxxr
雞	wxxr
奚	wxxs
䫣	wxxs
鐖	wxxw
鎭	wxxw
公	wxy
鉯	wxyw
釯	wya
龲	wyaf
锫	wyb
錇	wyb
镐	wybb
鎬	wybb
錞	wybc
𬭚	wybc
鍄	wybi
䥋	wybo
镶	wybq
锿	wybq
鎄	wybq
鑲	wybq
镦	wybt
鐓	wybt
钫	wyc
鈁	wyc
鎯	wyc
鑇	wycr
杀	wyd
弑	wydj
弒	wydj
殺	wydm
刹	wydn
剎	wydn
閷	wydw
锌	wyf
鋅	wyf
鏱	wyfg
鏣	wyfo
镀	wyfv
鍍	wyfv
鑛	wyfw
鈫	wyg
鉒	wyh
乂	wyii
㐅	wyii
䥰	wyll
䖊	wylm
镝	wymf
鏑	wymf
钪	wymg
鈧	wymg
铈	wyml
鈰	wyml
刈	wyng
鐘	wynj
镳	wyow
鑣	wyow
鬯	wyox
鍗	wypm
镱	wypu
鐿	wypu
㣻	wypu
镑	wypy
鎊	wypy
铱	wyq
銥	wyq
镜	wyqg
鏡	wyqg
䤳	wyry
铲	wys
郗	wysc
郄	wysc
郩	wysc
㕁	wysc
希	wysm
殽	wysm
肴	wysq
欷	wysq
鵗	wysq
㹷	wyss
敎	wyst
鏟	wyst
䥥	wysw
瓻	wysy
鍦	wytc
镞	wytt
鏃	wytt
镟	wytv
鏇	wytv
鉝	wyu
镰	wyuw
鐮	wyuw
锒	wyv
鋃	wyv
鎕	wyvb
鏮	wyvi
镛	wyvl
鏞	wyvl
錊	wywf
爼	wywm
铰	wyww
鉸	wyww
㸚	wyww
爻	wywy
鏕	wyx
䥝	wyx
凶	wyxl
铳	wyxq
兇	wyxq
銃	wyxq
錥	wyxq
锍	wyxr
鋶	wyxr
鏲	wyxt
㚇	wyxt
䤤	wyxw
铉	wyxx
鉉	wyxx
鉱	wyxy
发	x
䋗	xa
綫	xaat
䌔	xabb
緎	xabk
絾	xac
练	xaiw
絰	xaj
绖	xaj
缄	xakb
緘	xakb
縅	xakx
縬	xali
绒	xas
絨	xas
绕	xasx
线	xat
繿	xatm
纜	xatq
䌫	xatq
緻	xatw
䋌	xav
䌑	xavj
䋐	xax
辔	xaxb
轡	xaxb
絗	xbb
絽	xbb
缲	xbbd
繰	xbbd
繟	xbbf
綑	xbd
絪	xbg
𬘡	xbg
缉	xbhd
緝	xbhd
缋	xblm
繢	xblm
縜	xbm
绳	xbnx
䋲	xbnx
绢	xbq
絹	xbq
织	xbw
縕	xbwm
绍	xcb
紹	xcb
䋚	xcc
䌻	xcc
䋪	xckb
䊶	xcl
糿	xco
䌦	xcrl
䌌	xcrn
糼	xct
綎	xctj
𬘩	xctj
綖	xctl
𫄧	xctl
䋼	xcvm
絕	xcvn
缪	xcwe
繆	xcwe
级	xcy
纫	xcy
紉	xcy
級	xcy
綛	xcyp
䊾	xd
綝	xdd
𬘭	xdd
䌝	xddj
䌮	xddm
絤	xdg
缚	xdgy
縛	xdgy
縳	xdgy
緸	xdj
缥	xdji
縹	xdji
繧	xdjx
絊	xdk
綇	xdk
缃	xdm
緗	xdm
繐	xdpu
繻	xdsm
𦈡	xdsm
㯋	xdsw
䋠	xdu
䌚	xdud
䌢	xdwp
䋱	xdww
䌁	xdxk
絉	xdy
䋸	xefm
绗	xeg
絎	xeg
紤	xek
縰	xell
縦	xeul
縱	xewl
䌍	xfbh
䌯	xfbr
缂	xff
緙	xff
綨	xfh
縙	xfhd
绀	xfj
紺	xfj
悳	xfmp
緓	xfms
绬	xfms
缜	xfmw
縝	xfmw
䌩	xfmy
緢	xfnb
纎	xfnk
縸	xfns
繊	xfnu
䌙	xfnw
綍	xfpc
纄	xfph
䌇	xfpx
䌨	xfqj
繱	xfqp
繖	xfqt
鸨	xfqx
鴇	xfqx
䌭	xfro
䌲	xfto
䋻	xfu
䌾	xfu
駂	xfv
续	xfvs
䌋	xfwb
绁	xfx
紲	xfx
緤	xfxd
雝	xgbr
邕	xgbv
巤	xgbx
㜽	xgck
巛	xgii
巜	xgii
煭	xgko
甾	xgnb
勦	xgnc
鄛	xgnc
䣎	xgnc
巢	xgnd
疀	xgnl
剿	xgnn
㓯	xgnn
鶅	xgnq
災	xgow
絿	xgoy
䊷	xgt
䌶	xgt
纣	xgy
紂	xgy
绑	xhc
綁	xhc
䋙	xhd
䌺	xhd
䌰	xhhh
䋘	xhi
绩	xhmw
績	xhmw
綪	xhq
𬘬	xhq
縥	xhtd
緅	xhvy
縤	xhx
匕	xi
纟	xiii
糸	xiii
乚	xiii
糹	xiii
绱	ximb
緔	ximb
绡	xiq
綃	xiq
䌃	xiqn
絒	xir
颍	xisw
潁	xisw
絖	xisx
纱	xit
紗	xit
䋝	xixk
结	xjb
結	xjb
繥	xjbb
缬	xjbs
纈	xjbs
纬	xjc
絓	xjj
䋽	xjjg
繞	xjjs
红	xjl
紅	xjl
續	xjmm
绪	xjn
緒	xjn
続	xjpq
綕	xjpu
頴	xjsw
颕	xjsw
緈	xjuj
䌸	xjv
䌧	xjvg
繬	xjwb
䊿	xjwg
纉	xjwm
绫	xjwt
綾	xjwt
䊸	xjx
纭	xjxy
紜	xjxy
紶	xjxy
緖	xjy
女	xk
姬	xka
姫	xka
嫗	xkab
嫟	xkab
㛾	xkab
娍	xkac
姪	xkaj
㜮	xkam
㜯	xkao
嫕	xkap
嬺	xkap
㜛	xkaq
娆	xkas
娀	xkas
姖	xkav
妪	xkaw
媙	xkax
㚤	xkay
如	xkb
䋍	xkb
㛎	xkbb
嬠	xkbd
桇	xkbd
婟	xkbf
嬋	xkbf
姻	xkbg
綀	xkbi
妕	xkbl
娖	xkbl
媼	xkbm
嬇	xkbm
帤	xkbm
㜏	xkbm
㛣	xkbm
䋹	xkbn
䌿	xkbn
恕	xkbp
娟	xkbq
鴽	xkbq
㚾	xkbq
䘫	xkbq
娱	xkbs
娛	xkbs
挐	xkbt
孍	xkbt
㛕	xkbv
娲	xkbw
娯	xkbw
絮	xkbx
㖲	xkbx
邚	xkc
婀	xkcb
妱	xkcb
㚳	xkcb
㚸	xkcb
娜	xkcc
㚺	xkcc
㛆	xkcd
嫪	xkce
㚨	xkcf
好	xkck
她	xkcl
娫	xkcl
奶	xkcp
恏	xkcp
嫷	xkcq
嬥	xkcr
娗	xkct
㚫	xkcy
㛦	xkdd
㜤	xkdf
嫥	xkdg
㛉	xkdg
嫖	xkdj
㜁	xkdk
孀	xkdm
㜀	xkdm
嬬	xkds
婡	xkdw
婹	xkdx
嫮	xkdx
姤	xkeb
妡	xkek
㚱	xkek
㜡	xkel
㜱	xkem
㜫	xket
㛂	xkev
娦	xkew
姑	xkfb
嫱	xkfb
婼	xkfb
㛘	xkfc
媒	xkfd
媟	xkfd
娸	xkfh
媶	xkfh
嫤	xkfh
孏	xkfi
姏	xkfj
嬅	xkfj
嬞	xkfj
奸	xkfl
媾	xkfm
㛿	xkfm
㜴	xkfm
媌	xkfn
㛭	xkfn
嬿	xkfo
娔	xkfq
媩	xkfq
孉	xkfr
嫫	xkfs
媖	xkfs
婻	xkfu
妓	xkfv
嬳	xkfv
娂	xkfw
嫃	xkfw
嫨	xkfw
嫹	xkfw
㜓	xkfw
婲	xkfx
媅	xkfx
嫴	xkfy
纡	xkg
紆	xkg
㛏	xkgy
㛅	xkhd
㛞	xkhf
妦	xkhl
嫧	xkhm
媋	xkhn
婊	xkhq
婧	xkhq
嫀	xkht
㜜	xkht
娵	xkhv
嫊	xkhx
媣	xkid
嫦	xkim
㛥	xkin
㜭	xkin
娋	xkiq
姯	xkis
妙	xkit
嬯	xkja
嬉	xkjb
姞	xkjb
嬙	xkjb
嬦	xkjg
妹	xkji
娃	xkjj
㛬	xkjj
妅	xkjl
嬻	xkjm
媎	xkjn
娡	xkjp
㜇	xkjp
㥨	xkjp
妧	xkjq
媴	xkjq
妌	xkjr
嬈	xkjs
婈	xkjt
婞	xkju
嬄	xkju
㛸	xkju
妋	xkjw
姥	xkjx
妘	xkjx
㛈	xkjx
妸	xkkb
娪	xkkb
妺	xkkd
妍	xkkf
姸	xkkf
㚥	xkkg
娕	xkki
娻	xkki
婖	xkki
媡	xkki
娙	xkkj
姮	xkkk
婕	xkkl
奵	xkkl
姃	xkkl
娬	xkkl
姉	xkkm
嬾	xkkm
娅	xkkn
婭	xkkn
㜖	xkkn
嫣	xkko
嫰	xkkq
㚦	xkkr
妩	xkks
嫩	xkkt
㛁	xkku
㛒	xkku
姨	xkkw
嬭	xkkw
㛐	xkkw
婳	xkkx
孋	xkky
㛤	xkky
糽	xkl
㚲	xklb
婥	xklf
卐	xklk
絚	xklk
媫	xkll
䋊	xkll
婋	xklm
媜	xklm
㜘	xklm
嫭	xklu
婌	xklv
姛	xkmb
婤	xkmb
媧	xkmb
孈	xkmb
㛊	xkmd
姍	xkmf
婩	xkmf
姐	xkmh
練	xkmi
姌	xkmj
㚩	xkmj
姗	xkmk
㜄	xkml
姵	xkmm
媢	xkmm
㜥	xkmm
嫼	xkmo
㛶	xkmo
娊	xkmq
嬛	xkmq
㜹	xkmr
㜠	xkmr
姎	xkms
媏	xkms
嬽	xkms
㛧	xkms
媺	xkmt
嬍	xkmt
嬕	xkmu
㜐	xkmu
䌄	xkmv
妠	xkmw
婰	xkmw
㛝	xkmw
䋑	xkmw
㚯	xkmw
奾	xkmx
孆	xkmx
緉	xkmy
纚	xkmy
㚼	xknb
娚	xknc
婐	xknd
婸	xkne
㛫	xkne
娨	xknf
婔	xknf
娌	xknj
缰	xknk
妲	xknk
絙	xknk
繮	xknk
妽	xknl
媞	xknl
媪	xknm
㜼	xknm
娼	xknn
缙	xknn
縉	xknn
妯	xkno
媤	xknp
媦	xknq
㛱	xknq
嫚	xknv
绠	xknw
綆	xknw
娉	xknx
嫘	xknx
婫	xknx
嫐	xknx
媀	xkny
嬫	xkod
婒	xkoo
姚	xkoq
姹	xkpa
媈	xkpa
㜕	xkpa
嫆	xkpb
婉	xkpc
媥	xkpf
婝	xkpg
婃	xkpj
媗	xkpk
嬣	xkpk
婶	xkpl
嬪	xkpm
㚮	xkpm
㜚	xkpn
妉	xkpq
㛡	xkpq
嫁	xkps
嬘	xkps
妼	xkpt
㛽	xkpu
㣽	xkpu
㜆	xkpu
妒	xkpv
婠	xkpv
㛮	xkpv
嫔	xkpw
嬸	xkpw
嫇	xkpw
姲	xkpx
姁	xkqb
姳	xkqb
姽	xkqc
㚹	xkqc
㛯	xkqc
妳	xkqi
婙	xkql
媍	xkqm
婚	xkqn
姰	xkqn
媹	xkqn
嬼	xkqn
㜣	xkqo
娩	xkqq
姼	xkqq
嬝	xkqq
㛟	xkqs
嬎	xkqt
嬔	xkqt
婅	xkqu
㚬	xkqu
㛀	xkqv
㚿	xkqv
媰	xkqx
嫓	xkqx
妁	xkqy
奺	xkqy
婏	xkqy
㜬	xkqy
㜶	xkqy
婣	xkr
姠	xkrb
媿	xkrb
媬	xkrd
婢	xkrf
㜒	xkrf
媓	xkrh
㛛	xkrh
婎	xkrl
婂	xkrm
嫶	xkro
媳	xkrp
婗	xkrq
嬶	xkrr
㜩	xkrs
姙	xkrt
嬓	xkrt
嫂	xkrv
孇	xkrv
娰	xkrw
嬩	xkrw
嬹	xkrw
㛹	xkrw
媲	xkrx
㜃	xkry
妬	xks
娝	xksb
婍	xksb
娏	xkse
媷	xksg
嫄	xksi
嫽	xksi
䋬	xksi
娠	xksj
娾	xksj
媔	xksj
㛻	xksj
㚰	xksk
妚	xksl
㚴	xksm
䎟	xksm
姷	xksq
媠	xksq
㜧	xksq
媆	xkss
㛍	xksw
㛲	xksw
姱	xksx
㚭	xksx
㛪	xksx
妭	xksy
娥	xkta
奼	xkta
㚪	xkta
嬌	xktb
㛢	xktc
姀	xktd
奷	xktf
姓	xkth
㛔	xkth
姝	xkti
妊	xktj
媑	xktj
娷	xktk
妰	xktl
姡	xktm
孂	xktm
㜺	xktm
娳	xktn
嫵	xkto
姂	xktp
䶯	xktp
姺	xktq
娇	xktr
㛼	xktr
妖	xkts
姊	xktt
姩	xktt
㚵	xktu
妷	xktw
娒	xktx
婑	xktx
婾	xktx
嬟	xkua
嫸	xkub
婘	xkuc
娴	xkud
媨	xkud
嫻	xkud
婵	xkuf
姘	xkuf
孄	xkui
姅	xkuj
嫅	xkuj
㜋	xkum
媊	xkun
㛠	xkun
媯	xkuo
嬨	xkup
娧	xkuq
嫺	xkuq
媄	xkus
嫉	xkut
娣	xkut
嫾	xkut
嫌	xkuw
㜢	xkux
㛨	xkux
妫	xkuy
妈	xkv
媽	xkv
㚶	xkv
姄	xkva
媉	xkva
努	xkvc
妤	xkvc
孥	xkvc
㐐	xkvc
媃	xkvd
妞	xkvf
婮	xkvf
㜦	xkvg
妇	xkvh
娽	xkvh
𫰛	xkvj
妃	xkvk
嫿	xkvk
孎	xkvl
緁	xkvl
媚	xkvm
帑	xkvm
婦	xkvm
嬧	xkvm
㛚	xkvm
妑	xkvn
㛰	xkvn
怒	xkvp
婿	xkvq
鴑	xkvq
㜊	xkvq
砮	xkvs
娓	xkvt
媁	xkvt
拏	xkvt
㜟	xkvt
㜨	xkvt
嫋	xkvu
嬁	xkvu
弩	xkvv
驽	xkvv
娺	xkvv
婽	xkvv
駑	xkvv
胬	xkvw
妜	xkvw
妮	xkvx
娹	xkvx
緀	xkvx
䋈	xkvx
奴	xkvy
姶	xkwb
娢	xkwb
妢	xkwc
娐	xkwc
嬆	xkwc
婇	xkwd
㜝	xkwd
婨	xkwf
媕	xkwf
姾	xkwh
㚷	xkwi
㛋	xkwi
㛗	xkwj
孅	xkwk
㛵	xkwm
㛓	xkwm
媮	xkwn
嬒	xkwn
嬏	xkwn
嬀	xkwo
姈	xkwp
妎	xkwr
嫍	xkwr
㜎	xkws
婬	xkwt
媱	xkwt
嬡	xkwt
媛	xkwv
嫒	xkwv
妗	xkwv
嬐	xkww
䌤	xkww
妐	xkwx
娞	xkwx
䌳	xkwy
始	xkxb
㜰	xkxd
㜗	xkxe
姧	xkxf
經	xkxj
奻	xkxk
䊺	xkxk
㚣	xkxk
媸	xkxl
嬵	xkxm
㜻	xkxp
姢	xkxq
媘	xkxr
娭	xkxt
㛖	xkxt
㛌	xkxt
姆	xkxu
㜉	xkxv
姒	xkxw
㛴	xkxw
纯	xkxx
妣	xkxx
姦	xkxx
純	xkxx
㗠	xkxx
夨	xky
娮	xky
嬂	xkya
婄	xkyb
㜍	xkyb
妨	xkyc
嫏	xkyc
媇	xkyd
嫲	xkyd
嫡	xkyf
嫜	xkyf
㛙	xkyf
妏	xkyg
妵	xkyh
婛	xkyi
嫝	xkyi
㛇	xkyj
婷	xkyk
嬗	xkyk
嫞	xkyl
妔	xkym
媂	xkym
孊	xkyn
㜅	xkyn
㛺	xkyn
嫬	xkyo
嬑	xkyp
嬢	xkyq
孃	xkyq
㛄	xkyq
㛩	xkyq
㜵	xkyq
㜔	xkyq
㜳	xkyq
㚧	xkys
嬚	xkyu
娘	xkyv
嫙	xkyv
姣	xkyw
姟	xkyw
嬷	xkyx
妶	xkyx
嬤	xkyx
㜙	xkyx
嫎	xkyy
㜲	xkyy
㞷	xlh
凵	xlii
屮	xlii
丩	xlii
丱	xlii
䶹	xlii
㞢	xlk
蚩	xlkl
旹	xlkn
妛	xlkx
䊼	xll
緽	xlmw
绰	xlnf
綽	xlnf
纑	xlnm
雟	xlrb
爿	xls
戕	xlsa
牁	xlsb
牄	xlsb
牆	xlsb
㸛	xlsb
槳	xlsd
牀	xlsd
牃	xlsd
醬	xlsd
斨	xlse
弉	xlsf
㢡	xlsf
將	xlsg
漿	xlsi
墏	xlsj
壯	xlsj
㸜	xlsj
牅	xlsl
螿	xlsl
焋	xlso
裝	xlsq
奘	xlss
奬	xlss
狀	xlss
獎	xlss
牂	xlsu
䊢	xlsu
䵼	xlsv
銺	xlsw
妝	xlsx
娤	xlsx
孼	xltc
㔎	xltc
櫱	xltd
蠥	xltl
糱	xltu
收	xltw
辥	xlty
収	xlvy
㞣	xlwc
紪	xlx
㪿	xlxe
艸	xlxl
芔	xlxx
茻	xlxx
纲	xm
䋄	xm
絅	xmb
䌹	xmb
繷	xmfs
䌡	xmfu
组	xmh
組	xmh
缈	xmit
緲	xmit
纆	xmj
𬙊	xmj
绸	xmjb
綢	xmjb
繹	xmju
絧	xmkb
䌉	xmkl
缳	xmkq
繯	xmkq
绌	xmm
絀	xmm
缨	xmmx
纓	xmmx
繉	xmoq
縎	xmp
絸	xmqg
繃	xmqq
纗	xmrb
繀	xmrl
紻	xmsy
綱	xmum
網	xmuy
緺	xmvb
綗	xmwb
纳	xmwg
納	xmwg
䋞	xmww
郻	xmxc
纙	xmxr
旨	xn
细	xnb
細	xnb
䌈	xncc
綶	xnd
绯	xnf
緋	xnf
㔬	xnfg
縪	xnfj
繓	xnhv
縨	xnis
䋥	xnj
䋎	xnk
缇	xnkl
緹	xnkl
㔭	xnkl
䋿	xnkq
綥	xnkr
绅	xnl
紳	xnl
緼	xnmn
缊	xnmn
缦	xnmv
縵	xnmv
縄	xnnx
纝	xnnx
紬	xno
䌷	xno
缌	xnpu
緦	xnpu
緭	xnq
緆	xnqe
䋵	xnqw
鴲	xnqx
䍀	xntm
缆	xntq
䌜	xnuh
䭫	xnur
缧	xnx
縲	xnx
䭬	xnxm
絏	xnxt
绲	xnxx
緄	xnxx
緪	xokk
縆	xokk
緂	xoow
絩	xoqg
熲	xosw
颎	xosw
緷	xpaf
縺	xpaf
缱	xpbv
繾	xpbv
缤	xpew
绽	xpg
綻	xpg
縖	xphb
综	xpji
綜	xpji
綄	xpjq
𬘫	xpjq
繨	xpju
纻	xpk
縇	xpkk
紵	xpkl
繽	xpkm
縯	xpkw
𬙂	xpkw
编	xpmf
編	xpmf
䌏	xppm
綩	xpqc
紞	xpqg
𬘘	xpqg
缩	xprn
縮	xprn
綟	xpsu
綋	xpsx
缝	xpth
縫	xpth
缒	xptv
縋	xptv
繸	xpus
䍁	xpus
縌	xpux
绾	xpv
綰	xpv
䋆	xpv
䋉	xpw
紽	xpx
繩	xpx
縡	xpyf
纸	xqag
紙	xqag
緍	xqan
絇	xqb
絻	xqbq
纔	xqby
繲	xqct
緫	xqep
紣	xqfg
縩	xqji
绚	xqn
絢	xqn
绷	xqq
綳	xqq
繎	xqso
䊵	xqt
綯	xqtm
绹	xqtm
㔢	xqvc
㔃	xqvc
绉	xqvh
䋓	xqvh
䋫	xqvl
绝	xqvn
絶	xqvn
繺	xqvo
䊻	xqw
縐	xqxx
约	xqy
纨	xqy
約	xqy
紈	xqy
紃	xr
𬘓	xr
䌆	xrb
緥	xrbd
䌖	xrd
綼	xrfg
紨	xrgy
缎	xrhm
緞	xrhm
線	xrio
缐	xrio
缏	xrkw
緶	xrkw
维	xrl
維	xrl
䗽	xrl
縧	xrld
绵	xrml
綿	xrml
絈	xrn
纀	xrnu
䋩	xrqg
絥	xrsu
絍	xrtj
總	xrtp
缑	xrvt
緱	xrvt
繌	xrwt
缴	xryt
繳	xryt
缅	xsbj
緬	xsbj
缛	xsgy
縟	xsgy
绔	xsjx
絝	xsjx
䋔	xsk
绮	xskb
綺	xskb
紑	xsl
纋	xsmt
絔	xsn
緾	xsnj
纒	xsnj
絠	xsq
䋾	xsqq
縓	xsri
緛	xssy
䌬	xst
紎	xsu
缭	xsui
繚	xsui
绂	xsvy
紱	xsvy
顷	xsw
頃	xsw
䋶	xsw
綊	xsww
紌	xsx
紘	xsxy
纮	xsxy
乡	xt
䋃	xta
络	xtb
絡	xtb
纥	xtcg
紇	xtcg
絁	xtcl
绣	xtcp
綉	xtcp
绦	xtd
纤	xtfg
䊹	xtfg
缍	xtfk
綞	xtfk
䌗	xtfo
鄊	xthc
綘	xthl
絑	xtiw
紝	xtj
纴	xtj
緟	xtkj
纁	xtko
𫄸	xtko
蚃	xtl
䋅	xtl
绺	xtlb
綹	xtlb
䋏	xtlg
絬	xtm
緮	xtnt
䋺	xtow
䌣	xtpv
缵	xtqm
纘	xtqm
欵	xtqw
鄕	xtrc
繑	xtsb
颖	xtsw
穎	xtsw
绛	xttj
絳	xttj
终	xtu
終	xtu
䌀	xtuf
郷	xtvc
肄	xtvl
觺	xtvq
疑	xtvv
发	xtvy
㽈	xtvy
紩	xtwg
飨	xtwv
緌	xtxk
䋦	xtxu
兦	xty
嚮	xtyb
㗽	xtyb
鄉	xtyc
蠁	xtyl
㤀	xtyp
饗	xtyw
響	xtyy
母	xu
縂	xubp
绻	xuc
綣	xuc
㝀	xuck
毑	xucl
䋛	xud
繜	xudg
緧	xudk
断	xuek
絣	xuf
紏	xufg
絴	xuh
毌	xuii
绊	xuj
絆	xuj
縒	xujl
缯	xumn
繒	xumn
贯	xumw
貫	xumw
綐	xuq
繝	xuq
䋳	xuq
䌼	xuq
䌪	xuqr
繗	xuqt
絘	xuqw
䳇	xuqx
毋	xus
缮	xuub
繕	xuub
绨	xuvt
綈	xuvt
缣	xuw
縑	xuw
缢	xuwm
縊	xuwm
缕	xuxk
縷	xuxk
袰	xuyq
䋋	xvag
䌂	xvaj
缗	xvan
緡	xvan
繦	xvbl
緯	xvbt
䌟	xvby
纾	xvc
紓	xvc
纽	xvf
紐	xvf
䋧	xvfb
绿	xvh
緑	xvh
䌵	xvil
经	xvj
経	xvj
繣	xvjk
绎	xvjl
縀	xvjv
纪	xvk
彑	xvk
紀	xvk
彙	xvkd
彝	xvkf
彜	xvkf
彔	xvki
㣈	xvkm
㣇	xvkm
剝	xvkn
彘	xvkx
紖	xvl
纼	xvl
䋖	xvl
繡	xvlr
紦	xvn
䋟	xvpu
綅	xvpv
縃	xvq
绋	xvr
紼	xvr
彖	xvse
縁	xvse
蠡	xvsl
䗍	xvsl
盠	xvsm
剶	xvsn
劙	xvsn
鶨	xvsq
䋒	xvt
繘	xvtb
䋴	xvtd
繍	xvur
紴	xvv
縔	xvvd
缀	xvvv
綴	xvvv
繏	xvvw
䊽	xvwg
繈	xvxl
紭	xvxy
紁	xvy
䋇	xvy
䋮	xw
给	xwb
給	xwb
䌞	xwbw
綒	xwck
纷	xwco
紛	xwco
綵	xwd
䌽	xwd
紾	xwe
絼	xwe
乆	xwg
亾	xwg
絟	xwh
䌥	xwjp
绘	xwjx
絵	xwjx
缓	xwkv
緩	xwkv
綸	xwmf
繪	xwmn
䌐	xwmq
繙	xwn
紷	xwp
绶	xwpv
綬	xwpv
緰	xwqn
紒	xwr
㠩	xwr
縚	xwrj
絺	xwsm
𫄨	xwsm
䋡	xwt
䌊	xwtm
綌	xwwb
绤	xwwb
纵	xwwg
纖	xwwk
緃	xwwl
䋂	xwwy
纶	xwx
绥	xwxk
綏	xwxk
総	xwxp
縘	xwxs
緵	xwxt
紟	xwyv
比	xx
糺	xx
絲	xx
绐	xxb
紿	xxb
緿	xxbp
幻	xxc
孧	xxcc
㓜	xxco
鴢	xxcq
幼	xxct
枈	xxd
毕	xxfg
㩺	xxfv
坒	xxj
盭	xxjm
綠	xxki
毙	xxkx
纠	xxl
糾	xxl
鷆	xxmq
顚	xxms
眞	xxmw
缁	xxnb
緇	xxnb
缫	xxnd
繅	xxnd
㡫	xxnw
毖	xxpt
鷥	xxqx
勓	xxrc
樂	xxrd
皆	xxrn
鶛	xxrq
匘	xxrw
缘	xxse
緣	xxse
顈	xxsw
毞	xxta
继	xxud
粊	xxud
継	xxud
㿫	xxvv
纰	xxx
乣	xxx
紕	xxx
㡬	xxxc
纅	xxxd
斷	xxxe
縿	xxxe
㫁	xxxe
丝	xxxk
蠿	xxxl
幽	xxxm
畿	xxxn
鸶	xxxq
䫜	xxxs
㡮	xxxt
幾	xxxw
繼	xxxx
㡭	xxxx
幺	xxy
纞	xxyp
䘡	xxyq
乄	xy
織	xyat
台	xyb
䋨	xyb
缟	xybb
縞	xybb
邰	xybc
綧	xybc
𬘯	xybc
枲	xybd
䢄	xybd
㣍	xybe
綡	xybi
𫟅	xybi
繵	xybk
刣	xybn
炱	xybo
怠	xybp
綂	xybq
縗	xybq
纕	xybq
缞	xybq
㰧	xybq
𬙋	xybq
乨	xybx
瓵	xyby
辝	xyby
䌴	xyby
䌱	xyby
纺	xyc
紡	xyc
纃	xycr
䌕	xydd
弁	xyf
𨚕	xyfc
鴘	xyfq
䪻	xyfs
纊	xyfw
纹	xyg
紋	xyg
紸	xyh
厶	xyii
厼	xyiw
䋁	xymg
貟	xymw
贠	xymw
缠	xynj
纏	xynj
繂	xyof
缔	xypm
締	xypm
繶	xypu
𫄷	xypu
縍	xypy
䏍	xyq
允	xyqg
螚	xyql
䘅	xyql
熊	xyqo
熋	xyqo
㷱	xyqo
態	xyqp
䳌	xyqq
能	xyqx
鶭	xyqx
䏻	xyqx
緕	xyr
纩	xys
軬	xysa
参	xyse
叁	xysh
貵	xysm
畚	xysn
毵	xyst
奙	xysx
劺	xytc
牟	xytl
欸	xytq
鴾	xytq
矣	xyts
縼	xytv
䌅	xyvb
綷	xywf
以	xywg
鵕	xywq
纐	xyws
夋	xywt
皴	xywv
绞	xyww
絞	xyww
缡	xywx
縭	xywx
㕙	xywy
䌒	xyx
䜌	xyx
龻	xyx
㘘	xyxb
孿	xyxc
㝈	xyxc
欒	xyxd
㕖	xyxd
參	xyxe
卛	xyxf
斚	xyxf
㪻	xyxf
叄	xyxh
叅	xyxi
灓	xyxi
㕘	xyxi
垒	xyxj
亝	xyxj
蠻	xyxl
巒	xyxm
矕	xyxm
㡩	xyxm
剼	xyxn
曫	xyxn
戀	xyxp
统	xyxq
統	xyxq
鸞	xyxq
㓄	xyxq
䋭	xyxq
㱍	xyxq
奱	xyxs
䫩	xyxs
攣	xyxt
毿	xyxt
縴	xyxt
變	xyxt
彎	xyxv
絯	xyxw
臠	xyxw
鑾	xyxw
厽	xyxx
孌	xyxx
絃	xyxx
絫	xyxx
厸	xyxy
絋	xyxy
㕕	xyxy
㽋	xyxy
度	y
亡	ya
諓	yaat
吂	yab
謳	yabb
䊨	yabm
赢	yaby
嬴	yaby
羸	yaby
蠃	yaby
臝	yaby
贏	yaby
驘	yaby
鸁	yaby
䇔	yaby
诚	yac
邙	yac
誠	yac
杗	yad
诫	yaf
誡	yaf
诓	yah
誆	yah
誈	yaj
试	yajl
試	yajl
諴	yakb
𫍯	yakb
䜗	yakp
讶	yal
訝	yal
䖟	yal
蝱	yall
盲	yam
㠵	yaml
朚	yanq
忘	yapu
肓	yaq
衺	yaq
望	yaqh
谮	yaqn
譖	yaqn
巟	yar
䛋	yat
𬣡	yat
衁	yatm
讵	yav
詎	yav
氓	yava
讴	yawy
妄	yaxk
䛛	ybb
㐭	ybb
勯	ybbc
勷	ybbc
譟	ybbd
瓤	ybbe
譂	ybbf
䯬	ybbf
禀	ybbj
亶	ybbk
㔊	ybbn
㐯	ybbn
䜨	ybbp
襄	ybbq
鸇	ybbq
鹯	ybbq
颤	ybbs
顫	ybbs
氈	ybbt
稟	ybbt
讝	ybbt
皽	ybbv
谔	ybbx
諤	ybbx
㖜	ybbx
亨	ybc
郭	ybcc
㝇	ybcc
亸	ybcf
嚲	ybcf
㐔	ybcg
塾	ybcj
墪	ybcj
享	ybck
熟	ybco
烹	ybco
憝	ybcp
鹑	ybcq
鶉	ybcq
䃞	ybcs
䃦	ybcs
敦	ybct
撉	ybct
鐜	ybcw
㝄	ybcx
孰	ybcy
諿	ybhd
勍	ybic
㙶	ybij
蹵	ybil
剠	ybin
鹫	ybiq
鶁	ybiq
鷲	ybiq
就	ybis
京	ybiw
衰	ybkq
误	ybks
誤	ybks
㲤	ybkt
訲	ybl
䛤	ybll
䜋	yblm
䛱	yblp
衷	yblq
高	ybmb
鄗	ybmc
髝	ybmc
槀	ybmd
髞	ybmd
髜	ybmf
㙜	ybmj
髚	ybmm
毃	ybmm
歊	ybmq
髛	ybmq
鶮	ybmq
䯪	ybms
䯨	ybms
稾	ybmt
㪣	ybmt
敲	ybmv
䯩	ybmv
亯	ybn
畗	ybnb
㪟	ybnt
亳	ybpa
䯧	ybpb
亭	ybpk
亮	ybpm
膏	ybpq
亴	ybpq
豪	ybps
毫	ybpt
稁	ybpt
哀	ybq
詋	ybqg
裛	ybvq
识	ybw
䛊	ybw
方	yc
词	ycb
诏	ycb
詔	ycb
詞	ycb
诩	ycc
邡	ycc
詡	ycc
旔	yccv
讯	ycfg
訊	ycfg
瓬	ycky
訑	ycl
䜥	ycnk
䚮	ycp
㫉	ycqc
鴋	ycqx
謵	ycrn
旑	ycsb
䜏	ycsq
䫯	ycss
㫎	ycta
旖	yctb
㫊	yctb
施	yctc
斿	yctc
旂	ycte
旗	yctf
旚	yctj
誔	yctj
旜	yctk
诞	yctl
誕	yctl
䗐	yctl
䗠	yctl
㫌	yctl
旆	yctm
斻	yctm
斾	yctm
䞄	yctm
㫋	yctm
旝	yctn
旅	yctq
膂	yctq
旐	yctq
旓	yctq
鷟	yctq
𬸦	yctq
旒	yctr
旞	ycts
族	yctt
旌	yctt
旄	yctt
㫍	yctt
旋	yctv
旇	yctv
放	yctw
旍	yctw
旛	yctw
旟	yctw
膐	yctw
旎	yctx
㫏	yctx
旃	ycty
旊	ycty
齋	ycui
韲	ycuk
齏	ycuk
齍	ycum
齎	ycum
劑	ycun
齌	ycuo
齊	ycur
䐡	ycuw
䶒	ycux
㫈	ycwb
乻	ycwc
谬	ycwe
謬	ycwe
㫃	ycwg
㫆	ycwi
旙	ycwn
讔	ycwp
斺	ycwr
㫅	ycwr
於	ycwu
㫇	ycwv
旕	ycwx
旀	ycxi
訒	ycy
訯	ycy
讱	ycy
旘	ycya
堃	ycyj
譅	ycyl
䜧	ycyl
䜀	ycyl
認	ycyp
旈	ycyr
諃	ydd
諲	ydj
𬤇	ydj
謤	ydji
謣	ydjx
䜖	ydmw
谭	ydnf
譚	ydnf
譓	ydpu
𬤝	ydpu
譳	ydsm
誧	ydu
䜉	ydwi
誺	ydww
訹	ydy
䚲	ye
䜠	yeem
䛻	yefm
诳	yeh
誑	yeh
訢	yek
䜣	yek
诟	yekb
詬	yekb
謕	yelm
䛀	yevy
诉	yey
訴	yey
辛	yf
诂	yfb
詁	yfb
㖖	yfb
谨	yfbh
謹	yfbh
讙	yfbr
辦	yfcy
辧	yfcy
谋	yfd
謀	yfd
瓣	yfey
諽	yff
䜓	yffd
计	yfg
計	yfg
諆	yfh
㵷	yfiy
詌	yfj
讛	yfjx
辣	yfki
譁	yfkj
讦	yfl
訐	yfl
講	yfmj
謓	yfmw
諎	yfn
䜟	yfnk
謿	yfnq
谟	yfns
謨	yfns
譪	yfnw
䜕	yfny
誖	yfpc
㦚	yfpy
䜦	yfqn
䜘	yfqt
護	yfrv
誮	yfrx
㸤	yfry
诺	yfsb
諾	yfsb
谳	yfsu
㲔	yfta
諵	yfu
讌	yfuo
䜩	yfuo
辨	yfuy
读	yfvs
䚳	yfvy
䜤	yfw
鿁	yfw
谌	yfx
乵	yfx
詍	yfx
諶	yfx
谍	yfxd
諜	yfxd
辫	yfxy
辮	yfxy
辡	yfyf
谎	yfyr
謊	yfyr
辩	yfyy
辬	yfyy
辯	yfyy
文	yg
吝	ygb
㐎	ygcg
斈	ygck
彣	yge
対	yggy
斊	yghd
㪯	ygjl
斌	ygkl
贇	ygkm
赟	ygkm
𨭉	ygkw
蚉	ygl
螡	ygll
䘇	ygll
斔	yglw
螤	yglw
斍	ygmq
刘	ygng
斒	ygpf
忞	ygpu
亵	ygqq
㪱	ygqs
鳼	ygqx
鴍	ygqx
齐	ygr
斉	ygr
斎	ygrj
齑	ygrk
斖	ygrm
剂	ygrn
剤	ygrn
﨎	ygrv
斋	ygsm
㪰	ygud
斓	ygui
斕	ygui
紊	ygx
㓙	ygxl
讨	ygy
討	ygy
䝺	ygym
斏	ygyv
主	yh
䛫	yha
讍	yhbb
誀	yhd
䛶	yhd
诪	yhgy
讘	yhhh
譿	yhhp
诔	yhi
誄	yhi
殶	yhmv
謮	yhmw
请	yhq
請	yhq
諘	yhq
謸	yhtw
诹	yhvy
諏	yhvy
䛾	yhx
言	yi
讠	yiii
丶	yiii
亠	yiii
乀	yiii
乁	yiii
訁	yiii
讜	yimo
昶	yin
誻	yin
譡	yinb
永	yio
氷	yio
谠	yip
诮	yiq
誚	yiq
詶	yir
訬	yit
䚱	yiw
诘	yjb
詰	yjb
譆	yjbb
讳	yjc
誟	yjck
诗	yjgy
詩	yjgy
诖	yjj
詿	yjj
譊	yjjs
䜁	yjjy
讧	yjl
訌	yjl
讀	yjmm
讟	yjmy
诸	yjn
諸	yjn
読	yjpq
誌	yjpu
䛃	yjqg
讲	yjr
䛭	yjuj
䙝	yjuq
譸	yjvg
讃	yjwm
譛	yjwn
褻	yjwq
诬	yjww
誣	yjww
詓	yjxy
诃	ykb
訶	ykb
謌	ykbb
誎	ykbi
諨	ykbn
䛿	ykbu
䛠	ykbu
訮	ykf
訏	ykg
𬣙	ykg
订	ykl
訂	ykl
证	ykll
証	ykll
谏	ykmi
諫	ykmi
䜊	ykmn
諌	ykni
䜑	yknp
䛩	yknu
詽	yksf
䚶	yksy
评	ykuk
評	ykuk
语	ykvb
語	ykvb
誱	ykvl
誙	ykxj
訰	ykxx
谑	ylak
謔	ylak
詀	ylb
卞	ylg
讣	ylg
訃	ylg
让	ylk
讞	ylks
諔	ylkv
訨	yll
諕	ylmg
謯	ylmh
譃	ylnu
䜜	ylpm
謼	yltu
訿	ylx
詗	ymb
诇	ymb
䛇	ymb
邟	ymc
劥	ymct
譨	ymfs
讥	ymg
亢	ymg
诅	ymh
詛	ymh
褱	ymiq
调	ymjb
調	ymjb
䛁	ymjg
譯	ymju
詷	ymkb
𫍣	ymkb
譞	ymkq
𫍽	ymkq
㼚	ymky
市	yml
诎	ymm
詘	ymm
訵	ymn
誢	ymqg
㰠	ymqw
䲳	ymqx
讗	ymrb
䜅	ymrl
諯	ymsm
颃	ymsw
頏	ymsw
詇	ymsy
諷	ymtl
誷	ymuy
设	ymv
設	ymv
諣	ymvb
讷	ymwg
訥	ymwg
讽	ymwy
讪	ymx
訕	ymx
訉	ymy
音	yn
戠	ynat
亩	ynb
韻	ynbm
韶	yncb
䪧	yncl
课	ynd
課	ynd
裹	yndq
诽	ynf
誹	ynf
鄣	ynfc
䪬	ynfc
䤗	ynfd
彰	ynfe
章	ynfg
䛞	ynfl
赣	ynfm
贑	ynfm
贛	ynfm
䀍	ynfm
戆	ynfp
戅	ynfp
戇	ynfp
韺	ynfs
竷	ynft
頀	ynfv
䚯	yng
亰	yniw
髙	ynjb
䪦	ynjl
裏	ynjq
裏	ynjq
詚	ynk
諹	ynke
䪫	ynkj
諟	ynkl
𬤊	ynkl
韴	ynkm
䛣	ynkx
訷	ynl
韷	ynmm
谩	ynmv
謾	ynmv
誯	ynn
讄	ynnn
䛆	yno
䛅	ynp
韼	ynph
鷾	ynpq
意	ynpu
恴	ynpu
諰	ynpu
𠅤	ynpu
谓	ynq
裵	ynq
謂	ynq
竟	ynqg
竸	ynqq
韵	ynqu
歆	ynqw
谒	ynqw
謁	ynqw
嬜	ynqx
鶕	ynqx
䪮	ynqx
畝	ynqy
䪨	ynqy
韹	ynrh
謃	ynth
韸	ynth
㚆	yntw
譵	ynug
䥆	ynw
畒	ynwg
䛺	ynwr
谡	ynwt
謖	ynwt
䪩	ynwv
䛕	ynwy
䜙	ynxo
䛖	ynxt
䛰	ynxx
畆	ynxy
䪭	ynyn
䪰	ynyp
䜎	yooc
谈	yoow
談	yoow
誂	yoqg
率	yoxf
诨	ypaf
諢	ypaf
謰	ypaf
讉	ypbm
谴	ypbv
譴	ypbv
謆	ypcc
﨤	ypcy
諚	ypg
䜢	yphp
誴	ypji
𬣞	ypk
諠	ypkk
詝	ypkl
谝	ypmf
諞	ypmf
谊	ypmh
誼	ypmh
䜚	ypmi
谉	ypnl
䛷	ypqc
訦	ypqg
䜔	ypsq
䛑	ypt
诧	ypta
詫	ypta
谧	yptm
謐	yptm
悥	ypu
訫	ypu
谜	ypud
謎	ypud
鿪	ypuo
譢	ypus
䛪	ypvx
䛎	ypw
讅	ypwn
詑	ypx
譝	ypx
讁	ypyf
衣	yq
䚴	yq
䛡	yqab
諙	yqan
诋	yqay
詆	yqay
訽	yqb
詺	yqb
䜛	yqbq
谗	yqbu
讒	yqby
䛄	yqc
䘚	yqfg
裦	yqkq
褎	yqkq
褏	yqkq
襃	yqkq
裔	yqmb
讂	yqmt
询	yqn
詢	yqn
袌	yqq
袲	yqqq
誃	yqqy
谄	yqrj
諂	yqrj
诡	yqsc
詭	yqsc
谵	yqsy
譫	yqsy
訅	yqt
椉	yqtd
謋	yqtd
謠	yqtm
䛬	yqtm
諊	yqud
䛌	yqv
诌	yqvh
诤	yqvl
諍	yqvl
䚿	yqw
詾	yqwx
謅	yqxx
訋	yqy
訙	yqy
㫄	yqyc
训	yr
亣	yr
訓	yr
謉	yrb
褒	yrbq
䛙	yrd
諀	yrfg
谢	yrgy
詂	yrgy
謝	yrgy
諻	yrh
䜃	yrj
䛼	yrjl
譭	yrjm
谁	yrl
誰	yrl
詯	yrm
䛲	yrml
亹	yrmm
亱	yrnk
谯	yrow
譙	yrow
裒	yrq
褢	yrq
誽	yrqg
䜂	yrsf
㖱	yrtb
䛘	yrtj
謥	yrtp
鵺	yrtq
夜	yrty
䜒	yrus
謏	yrvy
謢	yrvy
𫍲	yrvy
谀	yrwg
諛	yrwg
䛜	yrwy
讹	yrx
訛	yrx
譤	yryt
广	ys
㐣	ysac
库	ysaf
庫	ysaf
庢	ysaj
庌	ysal
㡲	ysat
廤	ysax
㕻	ysb
㡶	ysbw
邝	ysc
㢌	yscb
廖	ysce
庭	ysct
㢞	yscw
廕	yscx
床	ysd
麿	ysdb
麻	ysdd
塺	ysdj
庮	ysdk
㡷	ysdk
廂	ysdm
黂	ysdm
䯢	ysdm
靡	ysdn
劘	ysdn
黁	ysdn
䵉	ysdn
爢	ysdo
㸏	ysdo
㦄	ysdp
䳸	ysdq
魔	ysdr
磨	ysds
摩	ysdt
麾	ysdt
犘	ysdt
穈	ysdt
䵇	ysdt
糜	ysdu
庯	ysdu
黀	ysdv
庲	ysdw
麽	ysdx
縻	ysdx
麼	ysdx
䜆	ysdy
诼	yse
諑	yse
庍	ysek
㢔	ysel
鄺	ysfc
㢙	ysfc
廝	ysfe
㫂	ysfe
廑	ysfh
䗪	ysfl
席	ysfm
廗	ysfm
鿮	ysfm
庴	ysfn
庿	ysfn
剫	ysfn
庶	ysfo
懬	ysfp
㢜	ysfp
鹧	ysfq
廟	ysfq
鷓	ysfq
㢍	ysfs
庋	ysfv
度	ysfv
庻	ysfw
廣	ysfw
庹	ysfy
庪	ysgv
㢅	yshf
廰	yshp
廳	yshp
廒	ysht
緳	yshx
应	ysik
廠	ysit
庄	ysj
誫	ysj
廧	ysjb
庨	ysjc
庤	ysjg
廚	ysjg
廅	ysjm
譇	ysjn
庱	ysjt
誇	ysjx
庒	ysjy
䛴	yskb
㡰	yskg
㢀	yski
庁	yskl
庑	ysks
㢄	ysku
庉	yskx
廲	ysky
店	yslb
㢚	yslc
廬	yslm
㢒	yslm
庛	yslx
䛔	ysm
㢐	ysmb
㡹	ysmh
廁	ysmn
䜡	ysmt
廮	ysmx
鄽	ysnc
䨾	ysnf
廛	ysnj
㢆	ysnj
㡺	ysnk
庙	ysno
庘	ysnp
㡼	ysnt
廙	ysnw
䛳	ysnx
庽	ysny
庣	ysoq
诙	ysow
詼	ysow
応	yspu
庐	yspv
廀	yspv
詴	ysq
㡳	ysqa
㡻	ysqc
䣌	ysqc
廫	ysqe
廇	ysqn
㢁	ysqq
廨	ysqt
㢝	ysqt
廯	ysqu
庖	ysqv
底	ysqy
㡱	ysqy
噟	ysrb
廆	ysrb
庥	ysrd
庳	ysrf
㢑	ysrf
府	ysrg
謜	ysri
螷	ysrl
蠯	ysrl
㢈	ysrl
廏	ysrm
焤	ysro
應	ysrp
鹰	ysrq
膺	ysrq
鷹	ysrq
㢋	ysrq
䧹	ysrr
廋	ysrv
腐	ysrw
庾	ysrw
譍	ysry
㢊	yssb
庬	ysse
㥷	yssp
庞	ysst
廈	ysst
龐	ysst
庵	yssx
庆	yssy
㢉	ysta
㡯	ysta
㢗	ystb
讈	ystl
㡸	ystl
廭	ystm
廡	ysto
㢎	ystr
庝	ystu
㢂	ystv
庅	ystx
庰	ysuf
庠	ysuh
䜍	ysui
劆	ysun
㢘	ysuo
廉	ysuw
廔	ysux
㡿	ysux
唐	ysvb
序	ysvc
鄌	ysvc
鄘	ysvc
㣑	ysve
康	ysvi
廜	ysvj
庸	ysvl
㡽	ysvl
赓	ysvm
廄	ysvm
廢	ysvm
賡	ysvm
廃	ysvq
廐	ysvq
鶊	ysvq
鶶	ysvq
鷛	ysvq
鹒	ysvq
㡾	ysvq
㱂	ysvq
㲥	ysvt
庚	ysvw
廦	ysvy
詙	ysvy
㼺	ysvy
庺	yswd
庂	yswg
座	yswj
廥	yswn
㢖	yswn
㢏	yswn
㡵	yswp
廞	yswq
𫷷	yswq
庎	yswr
庩	yswt
庈	yswv
㢛	ysww
䛟	ysww
庀	ysx
訧	ysx
廱	ysxr
㢕	ysxr
庼	ysxs
廎	ysxs
庇	ysxx
废	ysxy
広	ysxy
㢇	ysy
廊	ysyc
廓	ysyc
廍	ysyc
㢓	ysyf
廪	ysyj
庡	ysyq
廩	ysyt
㡴	ysyu
㢃	ysyv
廘	ysyx
䚽	yta
託	ytag
讬	ytag
誐	ytat
詻	ytb
讫	ytcg
訖	ytcg
诱	ytcp
誘	ytcp
訸	ytd
䛂	ytf
諈	ytfk
譕	ytfo
䛽	ytfr
诛	ytiw
誅	ytiw
诰	ytj
誥	ytj
䚾	ytj
许	ytk
許	ytk
諥	ytkj
䛮	ytlb
诈	ytlg
詐	ytlg
话	ytm
話	ytm
䛢	ytmg
誗	ytng
诜	ytqg
詵	ytqg
讚	ytqm
謻	ytqq
䛈	yts
譑	ytsb
訞	ytsy
䚺	ytw
譗	ytwb
詄	ytwg
袠	ytwq
诿	ytxk
諉	ytxk
诲	ytxu
誨	ytxu
立	yu
䇅	yuat
咅	yub
部	yubc
勏	yubc
䇍	yubl
剖	yubn
竞	yubq
競	yubq
䳝	yubq
㰴	yubq
䫓	yubs
敨	yubt
郶	yubv
㪗	yubv
瓿	yuby
翊	yucc
亲	yud
詸	yud
新	yude
竱	yudg
譐	yudg
親	yudq
䇕	yuds
㜪	yudx
竎	yuf
誁	yuf
竍	yufg
䚵	yufg
䇎	yufn
攱	yufv
详	yuh
詳	yuh
靖	yuhq
䇌	yuiq
竗	yuit
詊	yuj
竒	yukb
竦	yuki
谰	yuki
讕	yuki
竵	yuku
䇂	yul
站	yulb
竨	yulf
商	yumb
啇	yumf
竌	yumg
颯	yuml
譄	yumn
歒	yumq
端	yums
敵	yumt
竐	yumv
飒	yumw
甋	yumy
勭	yunc
𦒍	yunc
童	yunj
谱	yunn
譜	yunn
䚒	yunq
䴀	yunq
氃	yunt
諩	yunu
竭	yunw
竜	yunx
㼿	yuny
啻	yupb
㡣	yuph
竚	yupk
帝	yupm
竩	yupm
覫	yupq
鶙	yupq
䫕	yups
㿶	yupv
䒍	yupv
竤	yupx
㛳	yupx
旁	yupy
说	yuq
説	yuq
譋	yuq
谘	yuqb
竘	yuqb
諮	yuqb
谫	yuqc
謭	yuqc
譾	yuqc
竫	yuql
䇋	yuqq
讇	yuqr
鴗	yuqx
䇑	yurf
竧	yurh
产	yus
䇉	yus
彦	yuse
豙	yuse
竰	yusj
毅	yusm
剷	yusn
竡	yusn
颜	yuss
顔	yuss
顡	yuss
産	yust
亷	yusw
竑	yusx
竓	yuta
議	yuta
䇄	yutc
竏	yutf
竔	yutf
竬	yuty
䇆	yuuf
竴	yuug
竲	yuun
䇃	yuv
䇇	yuva
竮	yuvf
䇐	yuvi
䇈	yuvj
竳	yuvu
谦	yuw
謙	yuw
竕	yuwc
谥	yuwm
謚	yuwm
竛	yuwp
妾	yuxk
謱	yuxk
竣	yuxt
竢	yuxt
䇏	yuyc
暜	yuyn
竝	yuyu
䇊	yuyx
良	yv
䛉	yvag
諱	yvbt
郒	yvbv
郎	yvc
郎	yvc
郞	yvc
㓪	yvco
勆	yvct
鿥	yvcw
䚼	yvf
䛯	yvfb
譀	yvht
䜄	yvit
译	yvjl
记	yvk
記	yvk
證	yvku
訠	yvl
㐧	yvlt
诵	yvmj
誦	yvmj
誳	yvmm
䛝	yvmx
剆	yvng
誋	yvpu
誛	yvpv
朗	yvq
褭	yvq
詪	yvq
諝	yvq
谞	yvq
𬣳	yvq
㮾	yvqd
塱	yvqj
欴	yvqw
䛍	yvr
谲	yvtb
譎	yvtb
袤	yvtq
詖	yvv
诐	yvv
諁	yvvv
譔	yvvw
诀	yvwg
訣	yvwg
䛏	yvx
訍	yvy
訳	yvy
㕚	yvy
謘	yvyf
誸	yvyx
六	yw
詥	ywb
讑	ywbf
兗	ywbq
袞	ywbq
說	ywbq
譣	ywbw
孪	ywck
訜	ywco
栾	ywd
诊	ywe
診	ywe
弈	ywf
㐮	ywfq
认	ywg
诠	ywh
詮	ywh
諡	ywkm
谖	ywkv
諼	ywkv
䚷	ywkx
蛮	ywl
論	ywmf
帟	ywml
譮	ywmn
脔	ywmw
峦	ywmx
譒	ywn
詅	ywp
恋	ywpu
䛵	ywpv
谕	ywqn
諭	ywqn
鸾	ywqx
鵉	ywqx
亦	ywr
䚸	ywr
謟	ywrj
彥	ywse
䛥	ywsm
誵	ywsq
顏	ywss
產	ywst
奕	ywsy
挛	ywtg
谣	ywtm
謡	ywtm
譌	ywto
変	ywtw
弯	ywvx
变	ywvy
銮	yww
䛦	ywwb
郊	ywwc
効	ywwc
卒	ywwf
谶	ywwk
讖	ywwk
虠	ywwm
鵁	ywwq
䘱	ywwq
㰵	ywwq
䴔	ywwq
雜	ywwr
顇	ywws
頝	ywws
效	ywwt
㲞	ywwt
㿰	ywwv
交	ywwy
訤	ywwy
论	ywx
娈	ywxk
訩	ywxl
讻	ywxl
㐫	ywxl
衮	ywxq
兖	ywxq
離	ywxr
謑	ywxs
离	ywxx
讼	ywxy
訟	ywxy
义	ywy
亪	ywy
誝	ywyb
謒	ywyb
谂	ywyp
諗	ywyp
訡	ywyv
鹿	yx
䚰	yx
麙	yxab
诒	yxb
詒	yxb
袬	yxbq
麌	yxbs
麕	yxbt
麣	yxbt
鄜	yxc
䴥	yxcb
䴢	yxd
麢	yxdb
麜	yxdd
䴩	yxdj
䴫	yxdw
弃	yxf
棄	yxfd
麒	yxfh
塵	yxj
麠	yxkk
廌	yxko
㼾	yxky
訆	yxl
麂	yxmg
麆	yxmh
夣	yxmq
謴	yxmw
䴟	yxmy
诣	yxn
詣	yxn
䜈	yxnd
麃	yxow
䴪	yxpv
育	yxq
充	yxqg
麅	yxqv
㐬	yxr
麝	yxrg
壅	yxrj
雍	yxrl
䗸	yxrl
㽫	yxrn
麑	yxrq
罋	yxrt
饔	yxrw
甕	yxry
㻾	yxry
䛹	yxse
䴨	yxsi
麎	yxsj
麔	yxtb
麇	yxtd
䴤	yxth
麘	yxtn
诶	yxts
誒	yxts
䴠	yxts
䴣	yxtu
譺	yxtv
䴧	yxtx
麋	yxud
䛧	yxud
麟	yxut
麏	yxvb
麛	yxvh
慶	yxvt
麚	yxvv
詉	yxvy
詜	yxvy
鏖	yxw
劾	yxwc
郂	yxwc
亥	yxwg
㐪	yxwg
賌	yxwm
㱾	yxwm
刻	yxwn
欬	yxwq
詤	yxwr
颏	yxws
頦	yxws
誜	yxwt
麀	yxx
䚹	yxx
詏	yxxc
鄐	yxxc
謲	yxxe
畜	yxxn
玈	yxxq
䲻	yxxq
谐	yxxr
諧	yxxr
玅	yxxt
牽	yxxt
譏	yxxw
玆	yxxx
䜝	yxxx
玄	yxxy
䴦	yxy
麐	yxyb
麞	yxyf
麈	yxyh
麖	yxyi
麍	yxyr
麡	yxyr
麤	yxyy
誩	yy
識	yyat
謞	yybb
谆	yybc
諄	yybc
谅	yybi
諒	yybi
諪	yybk
譠	yybk
讓	yybq
譹	yybs
譈	yybt
访	yyc
訪	yyc
䜞	yycr
䛨	yyf
謶	yyfo
註	yyh
詠	yyio
䛸	yylb
謪	yymb
谪	yymf
謫	yymf
谙	yyn
諳	yyn
谛	yypm
諦	yypm
譩	yypu
谤	yypy
謗	yypy
谚	yyse
諺	yyse
譧	yyuw
誏	yyv
谇	yywf
誶	yywf
譲	yywq
䜇	yywq
詨	yyww
謧	yywx
议	yywy
该	yyxw
該	yyxw
詃	yyxx
譶	yyy
